,left,right,top,bottom,Name,height,width
0,656,1263,8,1903,epiphone-les-paul-sl-sunset-yellow,1895,607
1,664,1255,8,1911,schecter-banshee-mach-7-evertune-fob,1903,591
2,310,653,0,959,esp-ltd-ec-256-blks-black-satin,959,343
3,632,1295,16,1902,peavey-hp2-tremolo-deep-ocean,1886,663
4,648,1271,16,1903,fender-custom-shop-61-relic-telecaster,1887,623
5,160,311,0,471,ibanez-signature-uv70p-bk-steve-vai,471,151
6,376,575,176,783,epiphone-sg-special-p-90-sbu,607,199
7,640,1287,8,1911,ibanez-ndm5-sb-noodles-10132233,1903,647
8,296,647,16,943,duesenberg-fullerton-c-c-dcf-vw,927,351
9,325,631,16,943,yamaha-pacifica-112vm-rm,927,306
10,317,639,0,959,esp-ltd-h-1001qm-stblk,959,322
11,589,1333,0,1911,esp-ltd-ex-201-black-satin,1911,744
12,592,1327,8,1911,gretsch-guitars-streamliner-g2622-p90-havanna-burst,1903,735
13,664,1255,8,1911,ibanez-signature-jemjr-wh-steve-vai,1903,591
14,621,1303,0,1914,esp-ltd-ec-1000-goldand-gold-andromeda,1914,682
15,296,663,0,959,duesenberg-starplayer-tv-hollow-vb-hlw,959,367
16,656,1263,8,1919,ibanez-gio-grg170dx-bkn,1911,607
17,656,1263,0,1919,ibanez-premium-rgt1221pb-dtf-10149483,1919,607
18,648,1263,16,1903,sandberg-california-dc-ii-hca-mf-sg,1887,615
19,648,1271,0,1919,fender-american-vintage-ii-1961-stratocaster-owt,1919,623
20,640,1271,8,1911,squier-classic-vibe-50s-stratocaster-2ts,1903,631
21,648,1271,8,1911,fender-american-professional-ii-stratocaster-rw-mbl-10130690,1903,623
22,656,1263,8,1911,squier-super-sonic-tspg-shp,1903,607
23,320,639,0,959,esp-ltd-mh-200-blk-black,959,319
24,642,1271,8,1911,fender-vintera-50-s-strat-mod-dnb,1903,629
25,648,1271,8,1911,fender-ed-o-brien-stratocaster,1903,623
26,664,1255,0,1913,schecter-keith-merrow-km-7-mk-iii-hybrid-10147927,1913,591
27,632,1287,8,1911,evh-wolfgang-special-qm-chlorine-burst,1903,655
28,344,617,56,895,ibanez-jem7vp-steve-vai-wh,839,273
29,608,1311,0,1919,squier-contemporary-active-starcaster-shg,1919,703
30,320,639,8,959,yamaha-pacifica-012-rm,951,319
31,624,1295,8,1911,squier-paranormal-offset-tele-bpg-btb,1903,671
32,624,1295,0,1919,ibanez-standard-ar520hfm-lbb,1919,671
33,592,1327,8,1911,jackson-kelly-kex-shattered-mirror,1903,735
34,360,591,0,959,gretsch-guitars-g5715-lap-steel,959,231
35,640,1279,8,1911,squier-classic-vibe-60s-jazzmaster-3ts,1903,639
36,616,1303,0,1919,yamaha-revstar-rse20rcp-red-copper,1919,687
37,312,647,0,959,esp-ltd-te-200-maple-blk,959,335
38,304,655,0,959,eastman-sb59-v-antique-varnish,959,351
39,640,1279,8,1911,fender-player-plus-nashville-telecaster-3tsb,1903,639
40,624,1287,0,1911,evh-wolfgang-special-deep-purple-metallic,1911,663
41,336,615,72,879,esp-usa-horizon-ii-vn-duncan,807,279
42,632,1279,8,1911,fender-player-jaguar-pf-tpl,1903,647
43,648,1263,16,1903,duesenberg-ds3-ctb,1887,615
44,648,1271,8,1911,fender-player-stratocaster-mn-pwt,1903,623
45,592,1327,0,1919,ibanez-prestige-af2000-bs,1919,735
46,344,607,88,871,slick-sl-50-vsb,783,263
47,664,1250,16,1887,schecter-hellraiser-c-7-fr-blk-10150464,1871,586
48,344,619,56,903,ibanez-prestige-rg5121-dbf,847,275
49,320,631,0,959,gibson-les-paul-classic-honeyburst-10113955,959,311
50,632,1287,8,1911,gretsch-guitars-g6228tg-jet-players-edition-wlnt,1903,655
51,656,1263,8,1911,hagstrom-ultra-max-milky-mandarin-satin,1903,607
52,309,655,0,959,esp-ltd-viper-1000-tesb-tiger-eye-sunburst,959,346
53,648,1271,0,1919,schecter-hellraiser-c-1-fr-s-bch,1919,623
54,656,1263,8,1911,ibanez-prestige-rg5120m-prt,1903,607
55,624,1295,0,1919,evh-wolfgang-special-satin-surf-green,1919,671
56,312,647,8,951,esp-ltd-ec-1000-bp-blunfd,943,335
57,640,1271,8,1911,fender-player-jazzmaster-pf-bcr,1903,631
58,648,1263,8,1911,charvel-pro-mod-san-dimas-sc1-vintage-white,1903,615
59,309,653,0,959,esp-ltd-ec-1000fm-stp,959,344
60,656,1255,8,1903,charvel-usa-guthrie-govan-hsh-flame-maple,1895,599
61,640,1279,9,1903,schecter-blackjack-avenger-gblk,1894,639
62,600,1319,8,1911,eastman-t64-v-t-antique-goldburst,1903,719
63,616,1303,8,1911,d-angelico-deluxe-mini-dc-stw,1903,687
64,656,1263,8,1911,hagstrom-ultra-max-dark-strom-burst-gloss,1903,607
65,656,1263,8,1911,jackson-pro-dk-modern-ash-ht6-bk-red,1903,607
66,656,1263,16,1903,ibanez-signature-ps120-bk,1887,607
67,624,1295,0,1919,evh-wolfgang-special-qm-solar,1919,671
68,648,1271,8,1911,fender-vintera-60-s-strat-sfg,1903,623
69,664,1255,8,1903,ibanez-signature-atz10p-andy-timmons-stm,1895,591
70,565,1354,0,1917,esp-ltd-signature-kh-v-rsp,1917,789
71,648,1271,8,1911,fender-signature-strat-eric-johnson-rw-ttq,1903,623
72,656,1263,0,1919,ibanez-azes31-iv,1919,607
73,352,607,88,863,slick-sl-52-tv,775,255
74,648,1263,16,1905,vintage-v6mrssb,1889,615
75,328,638,0,959,ibanez-rga42fm-blf,959,310
76,640,1271,8,1911,fender-player-telecaster-mn-btb-10151245,1903,631
77,312,647,0,959,harmony-standard-series-silhouette-slate,959,335
78,312,647,8,959,guild-m-75-aristocrat-p-90-atb,951,335
79,640,1287,24,1898,prs-se-mccarty-594-singelecut-faded-blue,1874,647
80,616,1303,0,1919,yamaha-revstar-rss20ssb-sunset-burst,1919,687
81,640,1287,16,1911,haar-traditional-t-aged-sonic-blue-10140530,1895,647
82,664,1255,216,1703,guild-starfire-i-12-cherry-red,1487,591
83,312,639,8,959,redwood-relics-50s-t-style-roasted-mn-bsb-redwood-10150242,951,327
84,600,1327,16,1903,gretsch-guitars-g6120t-bshr-hr-ecgs-brian-setzer-signature,1887,727
85,633,1279,8,1911,hagstrom-swede-ltd-tiger-burst,1903,646
86,648,1271,8,1911,fender-custom-shop-dual-mag-stratocaster-heavy-relic,1903,623
87,616,1303,16,1895,prs-se-hollowbody-ii-charcoal-burst,1879,687
88,328,631,0,951,ibanez-prestige-az2204-icm-10146015,951,303
89,624,1295,8,1911,gretsch-guitars-g6228tg-jet-players-edition-cdg,1903,671
90,654,1271,8,1903,fender-custom-shop-1967-relic-strat-aged-sonic-blue-3tsb,1895,617
91,328,631,0,959,esp-ltd-buz-7-stblk-buz-mcgrath-signature,959,303
92,672,1239,240,1679,guild-starfire-iv-ch,1439,567
93,320,639,0,959,boss-eurus-gs-1,959,319
94,637,1283,0,1918,esp-ltd-te-201-black-satin,1918,646
95,640,1279,0,1919,yamaha-pacifica-112-rm,1919,639
96,322,631,8,951,g-l-fullerton-deluxe-asat-cl-flr,943,309
97,640,1271,8,1911,schecter-solo-ii-apocalypse-rr,1903,631
98,648,1271,8,1911,squier-contemporary-telecaster-rh-shoreline-gold,1903,623
99,320,634,8,951,esp-e-ii-horizon-fr-qm-blknb,943,314
100,608,1311,8,1911,schecter-sls-elite-e-1-bfb,1903,703
101,320,640,56,903,ibanez-as73fm-azg,847,320
102,320,631,8,951,prs-se-277-ca,943,311
103,328,631,8,958,esp-ltd-kh-demonology,950,303
104,336,639,0,951,schecter-c-6-deluxe-fr,951,303
105,616,1303,0,1919,yamaha-revstar-rss02thtm,1919,687
106,320,639,0,959,esp-ltd-h-51-car,959,319
107,296,663,8,951,hagstrom-viking-deluxe-baritone-cbk,943,367
108,312,647,0,959,esp-ltd-ec-1000-bk,959,335
109,600,1327,8,1911,gretsch-guitars-g6119-et-tennessee-rose-pro-player-s-edition-dcs-10144881,1903,727
110,304,655,0,959,eastman-sb59-v-antique-varnish-10150491,959,351
111,352,607,88,871,slick-sl-55-wh,783,255
112,656,1263,8,1911,schecter-reaper-6-elite-fr-s-bloodburst,1903,607
113,592,1327,0,1919,jackson-brandon-ellis-signature-kelley-green-crackle,1919,735
114,632,1287,8,1911,gretsch-guitars-players-edition-g6128t-jet-lotus-ivory-10149442,1903,655
115,328,639,8,959,suhr-classic-s-sss-owht,951,311
116,648,1271,16,1903,friedman-vintage-t-silver-flake-light-aged,1887,623
117,616,1295,8,1911,d-angelico-deluxe-mini-dc-sage,1903,679
118,640,1279,8,1911,yamaha-pacifica-112vmx-yns,1903,639
119,640,1271,0,1911,squier-classic-vibe-50s-telecaster-wbl,1911,631
120,312,639,8,959,danelectro-64xt-bk,951,327
121,656,1263,8,1911,ibanez-rg421g-lbm,1903,607
122,632,1287,16,1909,gretsch-guitars-electromatic-g5232t-double-jet-ft-csg,1893,655
123,576,1343,0,1919,duesenberg-fullerton-elite-catalina-blue,1919,767
124,632,1287,8,1911,sterling-by-music-man-cutlass-hss-fs,1903,655
125,648,1263,0,1911,fender-player-stratocaster-hss-pls-top-acb,1911,615
126,656,1263,8,1911,schecter-banshee-mach-6-evertune-fob,1903,607
127,656,1271,24,1903,sandberg-california-dc-ii-soft-aged-sg,1879,615
128,672,1247,8,1911,stagg-silveray-nash-deluxe-fsb,1903,575
129,648,1271,8,1911,fender-american-ultra-luxe-stratocaster-mn-hss-fr-svb,1903,623
130,648,1271,0,1919,hagstrom-ultra-max-golden-eagle-burst,1919,623
131,632,1287,8,1911,gretsch-guitars-g6659t-liv-bkstr-jr,1903,655
132,656,1263,16,1911,schecter-reaper-6-elite-bloodburst,1895,607
133,648,1271,8,1911,fender-custom-shop-56-stratocaster-heavy-relic,1903,623
134,600,1319,8,1911,squier-affinity-starcaster-mn-car,1903,719
135,328,631,0,951,ibanez-prestige-az2402-tff,951,303
136,323,634,8,959,vintage-icon-v62mrab,951,311
137,648,1263,16,1903,epiphone-les-paul-classic-worn-heritage-cherry-sunburst,1887,615
138,648,1271,0,1919,fender-american-ultra-stratocaster-rw-ultrbst,1919,623
139,656,1263,8,1911,charvel-pro-mod-dk-24-hh-fr-dark-amber,1903,607
140,600,1316,8,1911,squier-classic-vibe-starcaster-wal,1903,716
141,320,647,0,959,paoletti-richard-fortus-signature-no-3-cream,959,327
142,620,1299,0,1915,esp-ltd-ec-arctic-metal-snow-white-satin,1915,679
143,632,1287,8,1911,gretsch-guitars-g5220-electromatic-jet-bt-fsr,1903,655
144,640,1279,0,1919,squier-contemporary-active-jazzmaster-ssm,1919,639
145,648,1271,8,1911,fender-player-stratocaster-hss-mn-frd-ltd-edition,1903,623
146,5,930,8,959,heritage-custom-shop-core-collection-h-150-dirty-lemon-burst,951,925
147,656,1287,8,1911,gretsch-guitars-g5220-electromatic-jet-bt-dcm,1903,631
148,352,611,56,903,ibanez-axion-label-rgd71alms-bam,847,259
149,648,1271,0,1919,fender-american-vintage-ii-1973-stratocaster-agnat,1919,623
150,304,655,0,959,esp-ltd-viper-256-dbsb-dark-brown-sunburst,959,351
151,664,1255,0,1919,schecter-hellraiser-c-7-fr-bch,1919,591
152,712,1207,216,1695,guild-surfliner-white-sage-b-stock,1479,495
153,648,1271,0,1911,jackson-js-22-sc-monarkh-tb,1911,623
154,648,1271,0,1919,fender-signature-strat-eric-johnson-2tsb,1919,623
155,640,1271,0,1919,fender-vintera-60-s-strat-olw-limited-edition,1919,631
156,648,1271,8,1911,fender-70th-anniversary-esquire-lpb,1903,623
157,608,1303,0,1919,jackson-concept-series-rhoads-rr24-hs-wh-blk-pin,1919,695
158,648,1271,8,1911,fender-american-professional-ii-telecaster-mn-rst-pine,1903,623
159,608,1311,8,1911,jackson-pro-rhoads-rr24-maul-crackie,1903,703
160,328,623,72,879,esp-usa-eclipse-sbm-duncan,807,295
161,640,1274,16,1903,prs-ce24-blue-matteo-10147271,1887,634
162,632,1287,8,1911,sterling-by-music-man-valentine-toluca-lake-blue,1903,655
163,648,1271,8,1903,schecter-nick-johnston-traditional-ag-lefthand,1895,623
164,320,639,8,951,prs-s2-custom-24-08-ev,943,319
165,648,1263,8,1911,jackson-dinky-js24-dka-m-dx-red-stain,1903,615
166,648,1271,16,1895,fender-jim-root-jazzmaster,1879,623
167,280,679,0,959,gretsch-guitars-signature-g5191bk,959,399
168,592,1319,0,1919,gretsch-guitars-electromatic-g5420t-org-10150547,1919,727
169,648,1263,8,1911,fender-jimi-hendrix-stratocaster-mn-3ts-10145414,1903,615
170,208,735,0,959,hoefner-shorty-deluxe-black,959,527
171,658,1279,8,1895,vintage-v6mrhdx-summer-of-love,1887,621
172,656,1263,8,1911,sterling-by-music-man-john-petrucci-majesty-100-siberian-sapphire,1903,607
173,656,1263,8,1911,schecter-pt-sls-evil-twin,1903,607
174,624,1295,8,1911,d-angelico-deluxe-bedford-sh-blk,1903,671
175,664,1255,8,1903,schecter-john-browne-signature-tao-7-satin-trans-purple,1895,591
176,648,1271,0,1919,fender-american-vintage-ii-1975-telecaster-deluxe-mocha,1919,623
177,624,1303,8,1903,d-angelico-premier-bedford-sb,1895,679
178,648,1271,8,1911,fender-american-professional-ii-telecaster-mn-btb-10150723,1903,623
179,328,631,0,959,evh-striped-series-bw,959,303
180,648,1255,8,1919,ibanez-gio-grg170dx-bkn-10083991,1911,607
181,592,1327,8,1911,gretsch-guitars-g2420-streamliner-phantom-metallic,1903,735
182,656,1263,24,1895,friedman-vintage-s-vintage-white,1871,607
183,640,1279,8,1911,sterling-by-music-man-jason-richardson-cutlass-7-npb,1903,639
184,640,1279,8,1911,charvel-pro-mod-so-cal-3-hsh-fr-slime-green,1903,639
185,648,1255,16,1911,schecter-hellraiser-hybrid-c-1-fr-s-tbb,1895,607
186,592,1319,1,1911,jackson-proseries-king-v-kvt-3ts-10147584,1910,727
187,640,1271,8,1903,gretsch-guitars-g5421-jet-club-fr,1895,631
188,656,1263,0,1919,ibanez-azes40-ppk,1919,607
189,376,583,176,783,gibson-slash-les-paul-10145643,607,207
190,656,1263,0,1919,fender-player-lead-ii-neib-grn,1919,607
191,640,1271,0,1911,fender-playertelecaster-hh-pf-3ts,1911,631
192,656,1263,8,1911,jackson-mj-series-soloist-sl2-black,1903,607
193,648,1271,0,1919,squier-40th-anniversary-telecaster-gold-edition-blk,1919,623
194,648,1271,0,1919,fender-player-stratocaster-mn-pacific-peach,1919,623
195,640,1279,8,1911,squier-mini-jazzmaster-owh,1903,639
196,632,1287,8,1911,fender-vintera-60-s-jaguar-mod-sfg,1903,655
197,320,639,0,959,schecter-hellraiser-c-7-bch,959,319
198,320,639,0,959,esp-ltd-sc20-sob-stephen-carpenter-sonic-blue,959,319
199,312,641,0,951,esp-ltd-gh-600-sw,951,329
200,632,1287,0,1919,gretsch-guitars-electromatic-g5222-double-jet-black,1919,655
201,640,1279,0,1919,fender-jim-root-jazzmaster-v4-wht-10119364,1919,639
202,616,1303,8,1911,d-angelico-premier-mini-dc-sb,1903,687
203,283,679,0,959,esp-ltd-arrow1000-cars,959,396
204,592,1327,0,1919,gretsch-guitars-electromatic-g5622t-emtc-cb-dc-asp,1919,735
205,304,655,0,959,esp-e-ii-eclipse-ft-fm-black-natural-burst,959,351
206,320,639,0,959,redwood-s-style-owt-hss,959,319
207,549,1375,2,1908,esp-ltd-arrow-nt-black-metal-blks,1906,826
208,312,631,0,959,gibson-60th-anniversary-1961-sg-les-paul-standard-reissue-10140883,959,319
209,592,1319,8,1903,gretsch-guitars-streamliner-g2622t-tor,1895,727
210,608,1311,13,1903,eastman-thinline-t486b-classic-cla,1890,703
211,600,1327,64,1910,d-angelico-premier-exl-1-shb,1846,727
212,648,1271,8,1911,fender-american-professional-ii-strat-hss-mn-mys-sfg,1903,623
213,656,1263,24,1903,suhr-custom-standard-3ts,1879,607
214,360,599,176,783,epiphone-explorer-ebony,607,239
215,304,650,8,954,danelectro-dc59csb-12-string-hollowbody,946,346
216,309,647,0,959,esp-ltd-sn-1000fr-black-blast,959,338
217,0,783,0,957,danelectro-the-66-thinline-orange,957,783
218,616,1303,8,1911,ibanez-artcore-ag75-bs,1903,687
219,648,1271,8,1911,schecter-vintage-pt-gloss-black,1903,623
220,648,1263,16,1895,epiphone-les-paul-classic-worn-purple-10149974,1879,615
221,640,1287,8,1903,gretsch-guitars-g5426-jet-club-silver,1895,647
222,648,1271,8,1911,fender-american-professional-ii-telecaster-mn-btb,1903,623
223,656,1263,0,1919,fender-american-performer-strat-rw-hss-3tsb,1919,607
224,616,1303,0,1919,jackson-randy-rhoads-js32t-satin-black,1919,687
225,312,647,8,951,guild-jetstar-st-bk,943,335
226,344,617,56,903,ibanez-gio-grg7221qa-tks,847,273
227,648,1271,0,1919,squier-40th-anniversary-telecaster-gold-edition-blk-10150201,1919,623
228,648,1271,16,1911,sandberg-california-st-ii-hca-3tsb,1895,623
229,640,1279,0,1919,fender-jim-atkins-ja-90-telecaster-thinline-nat,1919,639
230,320,631,0,951,schecter-c-6-deluxe-10080855,951,311
231,288,679,0,959,heritage-standard-h-535-trans-cherry,959,391
232,640,1279,0,1919,fender-american-vintage-ii-1951-telecaster-btb,1919,639
233,624,1295,8,1911,evh-wolfgang-standard-exotic-koa,1903,671
234,648,1271,0,1919,fender-player-stratocaster-pf-3ts,1919,623
235,600,1319,0,1919,jackson-x-series-warrior-wrx24m-ferrari-red,1919,719
236,626,1293,0,1917,esp-ltd-phoenix-1000-stbs,1917,667
237,320,639,8,954,suhr-classic-alt-t-sfmg,946,319
238,565,1359,1,1911,esp-ltd-arrow-nt-arctic-metal-sws,1910,794
239,640,1279,8,1911,hagstrom-ultra-max-special-mystique-metallic,1903,639
240,640,1287,16,1903,prs-custom-24-wood-library-blue-fade,1887,647
241,648,1271,0,1919,squier-affinity-tele-mn-btb-10130539,1919,623
242,344,615,80,885,slick-sl-54-sg,805,271
243,672,1255,8,1911,jackson-x-series-slxdx-sb,1903,583
244,648,1263,16,1903,friedman-vintage-t-mn-hs-shell-pink,1887,615
245,640,1279,8,1911,d-angelico-deluxe-atlantic-vs-10142172,1903,639
246,616,1303,0,1919,yamaha-revstar-rss02tswb-swift-blue,1919,687
247,546,1386,0,1909,esp-ltd-snakebyte-camo,1909,840
248,648,1271,8,1911,fender-american-professional-ii-stratocaster-rw-owh,1903,623
249,624,1295,8,1911,d-angelico-deluxe-bedford-sh-le-sap,1903,671
250,352,610,56,903,ibanez-rgixl7-bk-iron-label,847,258
251,600,1311,8,1911,jackson-king-v-x-series-kvxmg-stn-blk,1903,711
252,624,1295,8,1911,esp-signature-james-hetfield-iron-cross,1903,671
253,640,1279,8,1911,squier-classic-vibe-60s-esquire-custom-3ts,1903,639
254,632,1279,0,1911,evh-wolfgang-special-sbk,1911,647
255,592,1327,0,1911,gretsch-guitars-electromatic-g5622t-emtc-cb-org,1911,735
256,656,1263,8,1903,schecter-silver-mountain-c-1-tv,1895,607
257,672,1247,16,1911,fender-player-offset-mustang-snb,1895,575
258,672,1247,8,1903,fender-player-offset-mustang-fmg,1895,575
259,600,1319,16,1903,d-angelico-premier-dc-fr-10133441,1887,719
260,312,639,8,951,esp-ltd-phoenix-1000-vw,943,327
261,336,638,0,959,ibanez-pgmm31-wh-paul-gilbert-mikro,959,302
262,648,1271,0,1919,fender-japan-traditional-50-stele-bsb,1919,623
263,640,1287,8,1911,ibanez-ndm5-sb-noodles,1903,647
264,648,1263,8,1903,epiphone-slash-les-paul-standard-vermillion-burst,1895,615
265,293,663,8,954,guild-starfire-iii-chr,946,370
266,648,1271,8,1911,fender-signature-strat-kenny-wayne-shepherd-tfsb,1903,623
267,384,575,176,783,epiphone-les-paul-prophecy-olivetiger,607,191
268,664,1247,8,1911,jackson-pro-mdk-7-ms-eureka-mist,1903,583
269,312,647,8,951,esp-ltd-ec-401-ow-10151665,943,335
270,320,639,0,959,yamaha-pacifica-212v-qm-tbs,959,319
271,664,1255,8,1911,schecter-c-1-fr-s-apocalypse-rr,1903,591
272,344,615,56,903,ibanez-rga42hpt-lbm,847,271
273,320,639,8,951,sandberg-california-dc-ii-mf-bk-masterpiece,943,319
274,296,663,8,951,hagstrom-fantomen-blk,943,367
275,640,1279,8,1911,fender-signature-johnny-marr-jaguar-owh,1903,639
276,648,1271,8,1911,schecter-omen-elite-6-stbb,1903,623
277,648,1271,0,1919,fender-aerodyne-special-telecaster-cab,1919,623
278,322,639,5,951,harmony-standard-series-silhouette-pearl-white,946,317
279,656,1263,16,1903,schecter-reaper-6-fr-inb,1887,607
280,608,1335,8,1911,gretsch-guitars-g5410t-rat-matwht,1903,727
281,344,619,56,903,ibanez-js240ps-ca-joe-satriani,847,275
282,640,1271,8,1903,jackson-monarkh-js22-sbk-10121910,1895,631
283,624,1295,8,1911,nik-huber-surfmeister-bigsby-candy-apple-green,1903,671
284,656,1255,8,1903,charvel-pro-mod-dk24-hh-2pt-cm-blk,1895,599
285,648,1271,8,1911,hagstrom-ultra-swede-esn-tobacco-sunburst-10131266,1903,623
286,312,647,0,959,esp-ltd-ec-1000-vland,959,335
287,320,639,0,959,fender-jim-root-telecaster-flat-white,959,319
288,296,674,0,959,ibanez-artcore-as73-tbc,959,378
289,640,1279,0,1919,yamaha-pacifica-112vm-gr,1919,639
290,656,1263,8,1911,ibanez-pia-3761-slw-steve-vai-signature,1903,607
291,646,1271,8,1911,fender-vintera-50-s-tele-sbl,1903,625
292,320,639,0,959,esp-ltd-eclipse-87-pw,959,319
293,648,1271,0,1919,fender-american-vintage-ii-1963-telecaster-sfg,1919,623
294,648,1263,8,1911,fender-american-performer-strat-rw-hbst,1903,615
295,641,1271,16,1903,peavey-hp2-tremolo-moon-burst,1887,630
296,296,663,8,951,hagstrom-hj-500-black-gloss,943,367
297,656,1263,16,1903,schecter-sc866-traditional-pro-tbb,1887,607
298,288,671,8,951,hagstrom-67-viking-ii-blkg,943,383
299,624,1263,8,1903,epiphone-les-paul-studio-alpine-white,1895,639
300,648,1271,0,1911,fender-telecaster-custom-telecaster-fmt-amber,1911,623
301,152,327,0,471,hagstrom-viking-deluxe-baritone-black-gloss,471,175
302,664,1255,0,1919,ibanez-azes31-vm,1919,591
303,640,1279,0,1919,jackson-pro-monarkh-sc-trans-purple,1919,639
304,636,1295,0,1917,esp-ltd-viper-400-baritone-blks,1917,659
305,640,1287,8,1903,prs-custom-24-black-goldburst,1895,647
306,640,1279,8,1911,fender-player-plus-nashville-telecaster-ospk,1903,639
307,648,1271,0,1919,fender-player-plus-stratocaster-hss-mn-3tsb,1919,623
308,289,631,0,951,schecter-jake-pitts-e-1-fr-s,951,342
309,640,1279,8,1911,fender-american-ultra-strat-hss-mn-ultrb,1903,639
310,648,1263,8,1903,jackson-dinky-js11-mbl-10126630,1895,615
311,600,1319,0,1919,ibanez-prestige-artstar-as2000-bs,1919,719
312,648,1271,0,1919,charvel-pro-mod-socal-style-1-gamera-black,1919,623
313,632,1287,1,1911,evh-wolfgang-special-pw,1910,655
314,351,631,88,863,fender-player-jaguar-pf-surf-pearl,775,280
315,648,1263,24,1895,gibson-custom-shop-1959-les-paul-standard-ultraheavyaged-10152220,1871,615
316,304,655,0,959,epiphone-sheraton-ii-pro-vs,959,351
317,629,1303,0,1919,esp-ltd-kh-3-spider-kirk-hammett-signature-incl-case-ltd,1919,674
318,648,1271,8,1911,charvel-pro-mod-angel-vivaldi-sign-luc-aq,1903,623
319,320,639,0,951,harmony-standard-series-rebel-burgundy,951,319
320,368,591,192,767,gibson-es-335-dot-vintage-ebony-10146619,575,223
321,648,1271,8,1911,fender-vintera-70-s-tele-deluxe-vbl-10114936,1903,623
322,600,1319,16,1903,ibanez-artcore-af55-tf,1887,719
323,632,1290,3,1915,esp-ltd-h-1001-vlands,1912,658
324,648,1271,16,1903,hagstrom-ultra-swede-esn-black-gloss,1887,623
325,640,1279,8,1911,haar-traditional-t-aged-vintage-white-10116155,1903,639
326,648,1255,8,1919,schecter-demon-6-fr-absn-10117531,1911,607
327,288,671,8,951,guild-starfire-i-sc-scw,943,383
328,656,1263,8,1911,schecter-sun-valley-ss-exotic-black-limba,1903,607
329,648,1271,8,1911,fender-custom-shop-fat-50s-stratocaster-relic-10144083,1903,623
330,648,1271,24,1903,prs-se-standard-24-08-tb,1879,623
331,592,1319,2,1911,jackson-kelly-js32t-ke-viola-burst,1909,727
332,620,1300,0,1915,esp-ltd-deluxe-ec-1000t-qm-charcoal-burst,1915,680
333,664,1255,1,1911,ibanez-j-custom-jcrg2002-gnm,1910,591
334,609,1311,8,1903,schecter-e-1-custom-special-edition-vs,1895,702
335,648,1271,8,1911,sterling-by-music-man-john-petrucci-jp70-mystic-dream,1903,623
336,728,1191,0,1919,gretsch-guitars-g5700-lap-steel-thti-rd,1919,463
337,624,1295,0,1919,gretsch-guitars-electromatic-g5232t-double-jet-ft-firestick-red,1919,671
338,576,1343,8,1911,jackson-pro-str-gus-g-sign-ivory,1903,767
339,305,647,0,959,esp-ltd-ec-256fm-dbsb,959,342
340,632,1287,8,1911,gretsch-guitars-streamliner-g2655t-p90-sahara-metallic,1903,655
341,664,1255,8,1911,schecter-silver-mountain-c-7-fr-s,1903,591
342,648,1271,0,1919,squier-affinity-strat-fmt-hss-bb,1919,623
343,656,1263,8,1911,jackson-pro-soloist-sla-unicorn-white,1903,607
344,328,631,8,951,fender-chris-shiflett-telecaster-deluxe-shg,943,303
345,306,647,0,959,danelectro-dc59-bk12-string,959,341
346,648,1271,8,1911,fender-player-stratocaster-mn-bcr,1903,623
347,656,1271,0,1911,jackson-dinky-js32-dka-pap,1911,615
348,576,1343,0,1919,jackson-x-series-kelly-kex-ferrari-red,1919,767
349,640,1279,0,1919,squier-classic-vibe-70s-tele-thinline-owt-litd-edition,1919,639
350,648,1271,0,1919,fender-american-vintage-ii-1961-stratocaster-wt3tb,1919,623
351,616,1303,16,1911,brian-may-special-ac,1895,687
352,648,1271,8,1911,fender-american-professional-ii-telecaster-mn-ssb,1903,623
353,296,671,5,954,epiphone-casino-vs,949,375
354,624,1295,8,1903,d-angelico-deluxe-bedford-sh-mwln,1895,671
355,600,1319,8,1903,gretsch-guitars-streamliner-g2420t-car,1895,719
356,592,1327,0,1919,hagstrom-super-viking-tobacco-sunburst,1919,735
357,600,1319,0,1919,gretsch-guitars-electromatic-g5622-emtc-cb-dc-aged-walnut,1919,719
358,648,1263,16,1903,maybach-teleman-t61-lpb,1887,615
359,656,1255,8,1903,fender-jimi-hendrix-stratocaster-mn-owt,1895,599
360,592,1327,8,1911,hagstrom-super-viking-dark-baltic-sea-flame,1903,735
361,648,1271,0,1919,fender-vintera-70-s-tele-moc,1919,623
362,584,1335,0,1919,gretsch-guitars-g5420t-electromatic-classic-azm,1919,751
363,656,1255,16,1903,epiphone-sg-custom-ebony,1887,599
364,328,631,16,943,harmony-standard-series-silhouette-bigsby-space-black,927,303
365,320,631,0,951,gibson-les-paul-classic-translucent-cherry,951,311
366,376,583,176,783,epiphone-les-paul-classic-heritage-cherry-sunburst,607,207
367,648,1263,8,1911,fender-japan-traditional-70s-telecaster-deluxe-sfmg,1903,615
368,584,1327,0,1911,gretsch-guitars-streamliner-g2622-phntm,1911,743
369,656,1263,16,1903,schecter-silver-mountain-c-1,1887,607
370,632,1287,8,1911,gretsch-guitars-streamliner-g2217-jr-jet-club-bt-fsr-dcm,1903,655
371,328,639,0,959,epiphone-les-paul-studio-lt-eb,959,311
372,619,1300,0,1919,ibanez-artist-ar520h-bk-10147747,1919,681
373,584,1335,0,1919,gretsch-guitars-electromatic-g5422tg-dc-org,1919,751
374,656,1263,8,1903,schecter-c-6-pro-cb,1895,607
375,648,1271,0,1919,squier-affinity-strat-mn-blk,1919,623
376,656,1247,8,1911,schecter-sls-elite-c-7-antique-fade-burst,1903,591
377,640,1279,8,1903,fender-signature-kurt-cobain-jaguar-3tsb-10096872,1895,639
378,632,1287,0,1919,squier-classic-vibe-60s-jaguar-charcoal-frost-metallic,1919,655
379,648,1271,0,1919,fender-vintera-60-s-strat-3ts,1919,623
380,616,1305,8,1911,d-angelico-deluxe-ss-sh,1903,689
381,640,1279,0,1919,fender-american-ultra-jazzmaster-rw-mbst,1919,639
382,312,642,8,951,esp-ltd-te-1000-evertune-fm-blknb-black-natural-burst,943,330
383,344,613,80,875,slick-sl-51-cr,795,269
384,328,631,8,959,esp-ltd-sh-207-brian-welch-signature,951,303
385,600,1327,8,1911,gretsch-guitars-g6120-eddie-cochran-signature-hollow-body,1903,727
386,664,1255,16,1909,schecter-sun-valley-fr-s-sbk,1893,591
387,640,1271,8,1911,squier-bullet-strat-ht-bsb,1903,631
388,648,1271,8,1911,charvel-pro-mod-san-dimas-style-1-hss-fr-platinum-pearl,1903,623
389,632,1287,0,1919,gretsch-guitars-electromatic-g5210t-p90-amethyst,1919,655
390,640,1279,16,1903,haar-traditional-t-ice-tea-burst,1887,639
391,648,1279,32,1903,prs-ce24-mccarty-sunburst-10148065,1871,631
392,648,1271,0,1919,fender-dave-murray-stratocaster-2ts,1919,623
393,648,1271,16,1903,slick-sl-50-bk,1887,623
394,640,1271,0,1911,squier-classic-vibe-60-s-telecaster-thinline-nat,1911,631
395,648,1279,0,1919,esp-ltd-m-1-custom-87-dmp,1919,631
396,656,1263,8,1903,schecter-c-1-exotic-ebony,1895,607
397,642,1271,8,1911,fender-vintera-50-s-strat-sbl,1903,629
398,296,669,8,948,guild-starfire-v-black,940,373
399,624,1295,0,1919,gretsch-guitars-electromatic-g5232t-double-jet-ft-broadway-jade,1919,671
400,576,1335,8,1903,jackson-king-v-js32-gbk,1895,759
401,648,1271,0,1919,fender-american-vintage-ii-1957-stratocaster-vbl,1919,623
402,656,1263,8,1911,schecter-silver-mountain-c-1-fr-s,1903,607
403,616,1295,0,1919,jackson-concept-series-rhoads-rr24-7-desert-camo,1919,679
404,600,1311,0,1911,gretsch-guitars-vintage-select-g6120t-59-chet-atkins,1911,711
405,296,655,6,956,guild-starfire-i-jet-90-sgld-b-stock,950,359
406,328,583,96,863,vintage-v100afd,767,255
407,600,1319,8,1911,gretsch-guitars-g6120t-hr-brian-setzer-hot-rod-lgld,1903,719
408,312,647,8,951,danelectro-59-m-nos-modified-wht,943,335
409,656,1263,8,1911,schecter-john-browne-signature-tao-6-satin-trans-purple,1903,607
410,648,1271,0,1919,fender-gold-foil-telecaster-eb-wbl,1919,623
411,592,1327,8,1911,jackson-pro-ke-jeff-loomis-blk-ash,1903,735
412,376,583,184,775,epiphone-uptown-kat-es-topaz-gold-metallic,591,207
413,608,1311,0,1919,ibanez-quest-qx54qm-bsm,1919,703
414,640,1295,16,1903,prs-se-starla-stoptail-pe,1887,655
415,648,1271,0,1919,fender-player-stratocaster-eb-neon-green-ltd-edition,1919,623
416,656,1263,8,1911,ibanez-rg421-bbs,1903,607
417,5,842,0,959,vintage-v100tbk,959,837
418,600,1327,8,1911,gretsch-guitars-g6118-et-anniversary-pro-player-s-edition-vwt,1903,727
419,648,1271,0,1919,fender-american-professional-ii-stratocaster-mn-dk-nit,1919,623
420,312,639,0,959,prs-john-mayer-silver-sky-fro,959,327
421,600,1319,8,1911,squier-affinity-starcaster-mn-owt,1903,719
422,584,1335,0,1919,hagstrom-tremar-viking-deluxe-csg,1919,751
423,312,639,32,927,esp-ltd-deluxe-ec-1000-vb-vintage-black-seymour-duncan-jb-59,895,327
424,640,1279,16,1903,prs-custom-24-08-10-top-eriza-verde,1887,639
425,293,663,0,959,epiphone-bb-king-lucille,959,370
426,296,663,0,959,heritage-standard-h-150-vintage-cherry-sunburst,959,367
427,632,1287,0,1919,gretsch-guitars-g5220-electromatic-jet-bt-brstl,1919,655
428,325,639,8,954,slick-sl-50-bwn,946,314
429,312,642,0,951,esp-ltd-gh-600-gary-holt-signature,951,330
430,648,1263,16,1903,duesenberg-starplayer-iii-ds3-ctr,1887,615
431,592,1327,0,1919,ibanez-artcore-af95fm-ays,1919,735
432,328,631,0,959,ibanez-rg565-lb,959,303
433,616,1303,8,1903,d-angelico-premier-mini-dc-cmp,1895,687
434,648,1271,16,1903,sandberg-california-st-h-qm-rw,1887,623
435,656,1255,8,1911,jackson-pro-dk-modern-ash-ht7-bk-blu,1903,599
436,640,1279,16,1903,yamaha-pacifica-112v-sb,1887,639
437,656,1263,0,1919,charvel-pro-mod-dk24-hss-fr-infinity-blue,1919,607
438,616,1297,0,1919,esp-ltd-sn-200ht-dmps,1919,681
439,664,1255,0,1919,squier-bullet-mustang-hh-blk-10103555,1919,591
440,600,1319,8,1911,gretsch-guitars-g6120t-hr-brian-setzer-hot-rod-lgld-10146164,1903,719
441,328,631,8,951,gibson-sg-standard-heritage-cherry,943,303
442,584,1335,8,1911,gretsch-guitars-g5410t-rat-matblk,1903,751
443,672,1247,8,1903,schecter-c-7-pro-ccb,1895,575
444,328,631,8,951,esp-e-ii-m-i-neck-thru-nt-blks,943,303
445,648,1271,8,1911,schecter-omen-extreme-6-vsb,1903,623
446,648,1271,0,1919,fender-japan-traditional-50-stele-wbl,1919,623
447,632,1287,16,1903,prs-se-mccarty-594-singelecut-black-gold-burst,1887,655
448,648,1271,8,1911,fender-jim-root-stratocaster-blk,1903,623
449,648,1271,0,1919,squier-classic-vibe-60s-tele-thinline-sonic-blue,1919,623
450,288,679,1,959,esp-ltd-arrow-black-metal-blks,958,391
451,656,1255,8,1903,charvel-pro-mod-dk24-hh-2pt-cm-blk-10148881,1895,599
452,288,666,2,951,guild-starfire-vi-slm,949,378
453,160,319,8,479,schecter-omen-6-blk,471,159
454,328,631,8,959,esp-ltd-m-black-metal-blks-black-satin,951,303
455,584,1335,2,1911,ibanez-signature-lgb300-vys-george-benson,1909,751
456,640,1279,24,1895,duesenberg-paloma-wh,1871,639
457,641,1271,8,1911,squier-classic-vibe-70s-stratocaster-blk,1903,630
458,720,1207,224,1695,guild-surfliner-sunset-orange,1471,487
459,656,1263,0,1919,jackson-pro-sl3m-rainbow-crackle,1919,607
460,624,1287,0,1911,gretsch-guitars-streamliner-g2655t-imprl,1911,663
461,320,639,0,951,redwood-s-style-blk-hss-mn,951,319
462,648,1271,0,1919,fender-american-professional-ii-stratocaster-mn-rst-pin,1919,623
463,640,1279,0,1919,fender-american-ultra-strat-hss-mn-txt,1919,639
464,656,1263,0,1919,ibanez-rg-premium-rg6pkag-ntf,1919,607
465,592,1327,24,1903,d-angelico-excel-59-db,1879,735
466,392,567,200,759,ibanez-pgmm11-jb-paul-gilbert-mikro,559,175
467,632,1287,0,1919,gretsch-guitars-electromatic-g5210-jet-p90-broadway-jade,1919,655
468,296,663,8,951,duesenberg-gran-majesto-dm2-ctg-s-10122723,943,367
469,664,1255,16,1903,ibanez-prestige-rgr652ahb-wk,1887,591
470,648,1271,8,1911,charvel-pro-mod-san-dimas-style-1-hh-fr-sunburn-ash,1903,623
471,616,1303,8,1911,d-angelico-premier-ss-ch,1903,687
472,640,1279,24,1903,haar-traditional-t-aged-sonic-blue-10122066,1879,639
473,672,1255,8,1911,fender-ben-gibbard-mustang,1903,583
474,640,1279,0,1919,charvel-pro-mod-sd-2-joe-duplantier-natural-mahogany,1919,639
475,656,1263,8,1911,jackson-js32q-dka-tgb,1903,607
476,0,959,0,959,gibson-60th-anniversary-1964-trini-lopez-10149332,959,959
477,360,607,104,855,vintage-reissued-v65vvw,751,247
478,656,1263,8,1911,jackson-mj-series-dinky-dkra-black-ash,1903,607
479,648,1271,8,1911,schecter-reaper-6-fr-s-ccb,1903,623
480,664,1255,8,1903,ibanez-premium-rgt1270pb-dtf,1895,591
481,616,1314,0,1919,esp-e-ii-eclipse-full-thickness-tsb,1919,698
482,656,1263,8,1911,ibanez-gio-grx70qa-sb,1903,607
483,662,1255,8,1911,schecter-sls-elite-c-1-fr-s-black-fade-burst,1903,593
484,632,1303,24,1895,vox-sdc-1-mini-rd,1871,671
485,656,1263,0,1919,jackson-x-series-soloist-sl3x-dx-frost-byte-crackle,1919,607
486,633,1287,24,1897,esp-ltd-ec-256-sw-snow-white,1873,654
487,632,1295,8,1911,prs-mccarty-594-10-top-dark-cherry-sunburst,1903,663
488,660,1261,0,1919,ibanez-axion-label-rg631alf-bcm,1919,601
489,632,1287,0,1919,fender-player-plus-meteora-hh-cosmic-jade,1919,655
490,272,687,0,959,danelectro-doubleneck-6-12-string,959,415
491,320,639,8,951,gretsch-guitars-signature-g6128t-gh-george-harrison-duo-jet,943,319
492,656,1263,8,1911,jackson-pro-soloist-sl2p-ht-black-burst,1903,607
493,312,658,0,954,ibanez-ftm33-stoneman-fredrik-thordendal,954,346
494,656,1263,16,1903,schecter-sc2177-reaper-6-custom-gbk,1887,607
495,584,1335,0,1919,gretsch-guitars-streamliner-g2622t-brwnstn,1919,751
496,328,632,16,943,harmony-standard-series-silhouette-bigsby-burgundy,927,304
497,616,1303,0,1919,yamaha-revstar-rse20bl-black,1919,687
498,360,607,88,863,slick-sl-51-db,775,247
499,368,599,176,783,epiphone-dot-es-335-vs-inspired-by-gibson,607,231
500,648,1271,8,1911,fender-noventa-tele-mn-2tsb,1903,623
501,656,1263,8,1911,ibanez-gio-grx40-mgn,1903,607
502,632,1279,0,1911,gretsch-guitars-streamliner-g2655t-fbl,1911,647
503,648,1271,8,1903,redwood-t-style-classic-mn-white-blonde,1895,623
504,600,1319,32,1903,d-angelico-premier-dc-black-flake-st,1871,719
505,648,1271,8,1911,fender-american-professional-ii-telecaster-dlx-rw-3tsb,1903,623
506,656,1271,16,1903,slick-sl-51-sg,1887,615
507,304,650,0,959,vintage-sg-vs6m,959,346
508,632,1295,0,1919,esp-ltd-sn-1000fr-sw,1919,663
509,621,1303,0,1911,esp-ltd-sparrowhawk-blk-10129142,1911,682
510,640,1279,0,1919,gretsch-guitars-streamliner-g2655t-cb-jr-wlnt,1919,639
511,664,1255,0,1919,jackson-x-series-soloistsla-6-dx-baritone-sbk,1919,591
512,288,671,0,951,gretsch-guitars-g100ce-an-synchromatic-cutaway-natural,951,383
513,648,1263,0,1911,jackson-js32q-dka-ah-fb-tr-blk,1911,615
514,320,639,8,951,gretsch-guitars-g5220-electronatic-jet-bt-blk,943,319
515,648,1263,16,1903,fender-custom-shop-1959-relic-stratocaster,1887,615
516,640,1279,8,1911,squier-mini-jazzmaster-sfg,1903,639
517,344,615,88,871,slick-sl-57-m-bk,783,271
518,621,1303,2,1911,esp-ltd-te-1000-evertune-koa,1909,682
519,640,1279,8,1911,fender-player-plus-nashville-telecaster-btb,1903,639
520,648,1271,24,1903,slick-sl-52-ba,1879,623
521,600,1311,8,1919,d-angelico-excel-ss-tour-solid-black,1911,711
522,648,1271,0,1919,fender-player-telecaster-mn-tpl,1919,623
523,344,617,56,903,ibanez-rg421hpah-bwb,847,273
524,328,623,0,951,jackson-pro-series-misha-mansoor-juggernaut-ht7-blk-brst,951,295
525,640,1271,8,1903,duesenberg-julia-bk,1895,631
526,608,1311,0,1919,duesenberg-starplayer-tv-vb,1919,703
527,648,1271,8,1911,schecter-signature-pt-mgk-machine-gun-kelly-downfall-pink,1903,623
528,664,1255,8,1903,schecter-c-7-apocalypse-fr-s-red-reign,1895,591
529,656,1255,0,1919,ibanez-az2204n-pbm,1919,599
530,320,631,8,951,sandberg-california-dc-ii-hca-bt-10133409,943,311
531,312,647,0,959,esp-ltd-ec-1000-evertune-stblk-see-thru-black,959,335
532,648,1271,0,1919,squier-affinity-telecaster-deluxe-mn-blk,1919,623
533,656,1263,8,1911,squier-mini-strat-blk-v2,1903,607
534,648,1271,0,1919,jackson-x-series-dinky-dk3xr-hss-caution-yellow,1919,623
535,632,1287,8,1895,danelectro-59m-spruce-f-hole-10084644,1887,655
536,328,630,32,927,esp-ltd-87-m-1-rbcrk,895,302
537,544,1378,0,1914,esp-ltd-lmk-600-blks-mille-petrozza-sign,1914,834
538,656,1263,0,1919,charvel-pro-modsan-dimas-style-1-hh-fr-sin-city-sparkle,1919,607
539,352,611,103,855,vintage-v100it-iced-tea,752,259
540,656,1263,8,1911,fender-player-lead-ii-blk,1903,607
541,632,1279,8,1911,squier-classic-vibe-60s-jazzmaster-snb,1903,647
542,320,631,8,959,g-l-fullerton-deluxe-asat-classic-bluesboy-org,951,311
543,656,1263,0,1919,schecter-nick-johnston-traditional-as-10131311,1919,607
544,640,1279,0,1919,charvel-pro-modsan-dimas-style-1-hh-fr-miami-blue,1919,639
545,656,1263,16,1895,epiphone-les-paul-muse-pearl-white-metallic,1879,607
546,624,1303,24,1895,vox-sdc-1-mini-bk,1871,679
547,632,1295,16,1911,danelectro-59x-db,1895,663
548,640,1279,8,1911,sterling-by-music-man-cutlass-ct30sss-daphne-blue,1903,639
549,648,1263,8,1911,ibanez-gio-grx40-mlb,1903,615
550,656,1263,8,1911,schecter-omen-elite-6-fr-bcb,1903,607
551,648,1271,0,1919,fender-eric-johnson-1954-virginia-stratocaster,1919,623
552,632,1263,24,1903,epiphone-les-paul-standard-60s-bourbon-burst,1879,631
553,664,1255,0,1919,jackson-american-series-soloist-sl3-riviera-blue,1919,591
554,320,631,80,879,eastman-thinline-t58-v,799,311
555,640,1271,8,1911,squier-classic-vibe-70s-tele-thinline-3-ts,1903,631
556,328,631,6,951,g-l-fullerton-deluxe-legacy-shr,945,303
557,313,647,8,951,ormsby-metal-x-gtr-6-dahlia-black,943,334
558,312,647,0,959,prs-john-mayer-silver-sky-tu,959,335
559,288,671,0,959,esp-ltd-ex-401-blk,959,383
560,656,1271,16,1903,slick-sl-60-tv,1887,615
561,632,1279,8,1911,fender-vintera-60-s-jazzmaster-ibm,1903,647
562,664,1255,0,1919,sterling-by-music-man-john-petrucci-majesty-170-siberian-sapphire,1919,591
563,656,1263,8,1911,jackson-soloist-sl1-dx-throwback-ppk,1903,607
564,320,639,6,959,esp-e-ii-horizon-ntfm-dbsb,953,319
565,652,1279,0,1919,esp-e-ii-horizon-fr-ii-tesb,1919,627
566,648,1271,8,1903,duesenberg-alliance-johnny-depp,1895,623
567,648,1263,8,1903,schecter-sun-valley-pt-fr-mw,1895,615
568,614,1303,0,1919,ibanez-amh90-crf,1919,689
569,320,639,8,951,redwood-relics-60s-s-style-hss-snb,943,319
570,656,1271,16,1903,haar-traditional-s-black-rw-aged,1887,615
571,656,1255,8,1903,jackson-dinky-js12-mbl-10113116,1895,599
572,664,1255,8,1911,gretsch-guitars-g5260t-emtc-jet-bari-slv,1903,591
573,632,1287,8,1911,fender-player-plus-meteora-hh-silverbursst-10145639,1903,655
574,280,671,0,959,esp-arrow-black-andromeda,959,391
575,600,1319,8,1911,squier-contemporary-active-starcaster-ibm,1903,719
576,344,615,64,895,haar-traditional-s-surf-green-over-sunburst-rw,831,271
577,656,1263,0,1919,jackson-chris-broderick-pro-soloist-6-gblk,1919,607
578,296,663,8,951,ibanez-signature-lgb30-nt-george-benson,943,367
579,344,615,88,871,suhr-classic-antique-sss-mn-blk,783,271
580,648,1271,0,1919,schecter-damien-platinum-7,1919,623
581,632,1287,8,1911,sterling-by-music-man-sub-axis-black,1903,655
582,576,1343,16,1903,guild-x-175-manhattan-special-bld,1887,767
583,624,1295,8,1911,evh-wolfgang-standard-qm-transparent-green,1903,671
584,320,631,8,951,duesenberg-starplayer-tv-mike-campbell-mc40,943,311
585,672,1255,24,1903,fender-player-offset-duo-sonic-tpl,1879,583
586,648,1271,0,1919,fender-nile-rodgers-hitmaker-stratocaster-10151746,1919,623
587,625,1295,0,1919,esp-ltd-te-1000-evertune-chms,1919,670
588,648,1263,8,1911,fender-player-stratocaster-pf-blk,1903,615
589,640,1279,8,1905,d-angelico-deluxe-brighton-mwln,1897,639
590,648,1287,16,1911,prs-se-standard-24-tb,1895,639
591,328,634,0,951,ibanez-signature-jemjrsp-ye-steve-vai-10103077,951,306
592,344,615,80,880,slick-sl-57-sg,800,271
593,649,1271,0,1919,ibanez-sew761fm-ntf,1919,622
594,328,647,8,959,godin-stadium-ht-trans-white-rn,951,319
595,312,634,8,951,yamaha-pacifica-112-ovs,943,322
596,656,1271,16,1903,haar-traditional-s-sea-foam-green-aged-amber-hss,1887,615
597,648,1271,0,1919,fender-american-professional-ii-stratocaster-rw-merc,1919,623
598,320,658,8,951,harmony-standard-series-comet-sunburst,943,338
599,648,1271,0,1919,fender-jv-modified-50s-stratocaster-hss-mn-2ts,1919,623
600,656,1263,0,1919,ibanez-gio-grg121sp-bkn,1919,607
601,664,1255,8,1911,ibanez-rg7421-wnf-10110344,1903,591
602,627,1298,24,1903,duesenberg-starplayer-tv-bls,1879,671
603,656,1263,0,1919,ibanez-prestige-rg652ahmfx-rpb,1919,607
604,648,1271,0,1919,squier-affinity-tele-lpb,1919,623
605,624,1295,8,1911,evh-wolfgang-standard-silver-sparkle,1903,671
606,317,642,8,951,guild-s-200-t-bird-blk-10133902,943,325
607,640,1279,0,1919,yamaha-pacifica-612-vii-fmx-fr,1919,639
608,632,1287,16,1903,nik-huber-krautster-ii-candy-apple-red-10144028,1887,655
609,320,639,8,951,fender-eric-johnson-stratocaster,943,319
610,640,1279,0,1919,squier-40th-anniversary-jazzmaster-gold-edition-owt,1919,639
611,312,650,0,959,esp-frx-cast-metal-andromeda-ii,959,338
612,648,1271,8,1911,fender-vintera-60-s-strat-ibm,1903,623
613,656,1263,0,1919,jackson-dinky-dk2xr-gloss-black-10127531,1919,607
614,656,1247,16,1903,fender-player-offset-duo-sonic-hs-ibm,1887,591
615,648,1279,16,1903,epiphone-les-paul-studio-wr-10119762,1887,631
616,648,1263,8,1911,fender-signature-strat-eric-johnson-rw-laf,1903,615
617,616,1327,16,1903,epiphone-dot-es-335-fbb-inspired-by-gibson,1887,711
618,360,581,2,951,bohemian-oil-can-guitar-bg25al,949,221
619,648,1271,8,1911,fender-american-performer-tele-rw-hbst,1903,623
620,296,663,8,951,guild-starfire-v-chr,943,367
621,648,1271,8,1911,fender-custom-shop-63-stratocaster-relic-10144153,1903,623
622,656,1263,8,1911,jackson-pro-soloist-sl7a-unicorn-white,1903,607
623,616,1303,16,1903,gibson-1964-trini-lopez,1887,687
624,648,1271,8,1911,squier-contemporary-telecaster-rh-pearl-white,1903,623
625,320,639,0,959,esp-ltd-signature-kh602-bk-kirk-hammett,959,319
626,624,1298,0,1914,esp-ltd-te-1000-blkblast,1914,674
627,648,1271,8,1911,jackson-pro-dk2-baked-white,1903,623
628,624,1295,8,1911,d-angelico-deluxe-bedford-sh-le-sage,1903,671
629,288,663,8,951,jackson-king-v-kv-gbk,943,375
630,624,1295,0,1919,ibanez-artist-ar520hfm-vls,1919,671
631,312,653,0,959,esp-ltd-as-1-lb-alex-skolnick-signature-lemon-burst,959,341
632,648,1271,8,1911,charvel-pro-mod-san-dimas-3-hss-blk-sassfras,1903,623
633,648,1263,8,1909,schecter-nick-johnston-traditional-ac,1901,615
634,640,1287,13,1903,esp-ltd-volsungd-blks,1890,647
635,640,1279,8,1911,fender-american-ultra-luxe-telecaster-mn-2csb,1903,639
636,664,1255,0,1919,jackson-concept-series-soloist-h-s-walnut,1919,591
637,320,641,0,959,esp-ltd-mh-200qm-nt-stbc-see-thru-black-cherry,959,321
638,656,1271,16,1911,slick-sl-59-vsb,1895,615
639,592,1319,8,1903,gretsch-guitars-streamliner-g2622t-tor-10143620,1895,727
640,616,1303,0,1919,duesenberg-paloma-csr,1919,687
641,600,1327,8,1911,ibanez-signature-jsm10-vys-john-scofield,1903,727
642,312,647,8,951,guild-aristocrat-p-90-vs,943,335
643,648,1271,8,1911,squier-contemporary-stratocaster-special-blk,1903,623
644,656,1263,16,1903,schecter-nick-johnston-traditional-ag,1887,607
645,640,1279,0,1919,squier-40th-anniversary-vintage-edition-jazzmaster-sdsd,1919,639
646,648,1271,0,1919,jackson-pro-gus-g-sig-car,1919,623
647,632,1279,8,1903,gretsch-guitars-g6128t-ruo-pe,1895,647
648,656,1255,8,1903,ibanez-rg421-mol,1895,599
649,632,1287,8,1911,fender-vintera-60-s-jaguar-oct,1903,655
650,315,642,8,959,blackstar-carry-on-travel-guitar-black,951,327
651,312,647,8,959,brian-may-special-limited-metal-may,951,335
652,664,1247,0,1911,jackson-dinky-js32-dka-nto-10121332,1911,583
653,304,652,5,951,harmony-standard-series-comet-trans-res,946,348
654,600,1327,8,1903,gretsch-guitars-electromatic-g5622t-emtc-cb-imprl,1895,727
655,384,575,176,783,epiphone-prophecy-sg-red-tiger-aged-10150822,607,191
656,640,1279,0,1919,yamaha-pacifica-612-vii-fm-yellow-natural-satin,1919,639
657,320,641,8,959,esp-ltd-sn-1000ht-r-chm,951,321
658,664,1255,0,1919,jackson-american-series-soloist-sl3-satin-slime-green,1919,591
659,632,1287,0,1919,fender-player-plus-meteora-hh-bel-air-blue,1919,655
660,640,1279,8,1911,hagstrom-ultra-max-special-amaryllis-flame,1903,639
661,640,1279,16,1903,prs-s2-custom-24-faded-grey-black-green-burst,1887,639
662,616,1303,2,1911,d-angelico-deluxe-ss-sbb,1909,687
663,664,1255,0,1919,ibanez-rga622xh-bk,1919,591
664,293,663,0,951,ibanez-signature-jsm100-vt-john-scofield,951,370
665,584,1335,0,1919,gretsch-guitars-g5420t-electromatic-classic-wlnt,1919,751
666,640,1279,0,1919,fender-gold-foil-jazzmaster-eb-shg,1919,639
667,648,1271,0,1919,jackson-pro-dk2-green-glow,1919,623
668,656,1263,8,1911,jackson-pro-soloist-sl7aht-unicorn-white,1903,607
669,648,1271,8,1911,fender-american-professional-ii-tele-dlx-mn-mbl,1903,623
670,648,1271,8,1911,fender-signature-strat-eric-clapton-owh,1903,623
671,664,1255,0,1919,gretsch-guitars-g5260-electromatic-jet-bari-imrl,1919,591
672,608,1311,0,1919,duesenberg-starplayer-tv-cab,1919,703
673,624,1295,8,1910,d-angelico-premier-mini-dc-bf,1902,671
674,320,639,8,959,esp-ltd-ec-257-blks,951,319
675,584,1327,8,1911,gretsch-guitars-streamliner-g2622-p90-claret-burst,1903,743
676,648,1271,8,1903,schecter-apocalypse-solo-ii-red-reign,1895,623
677,656,1263,8,1911,ibanez-thbb10,1903,607
678,624,1295,0,1919,gretsch-guitars-electromatic-g5230t-nick-13-tiger-jet-blk,1919,671
679,598,1325,8,1911,d-angelico-premier-dc-ot,1903,727
680,656,1263,0,1919,ibanez-signature-jemjr-bk-steve-vai,1919,607
681,640,1279,16,1903,haar-traditional-t-vintage-burst,1887,639
682,648,1263,16,1903,haar-traditional-s-aged-olympic-white-10120684,1887,615
683,320,639,0,959,charvel-warren-demartini-signature-blood-and-skull,959,319
684,624,1295,8,1911,evh-wolfgang-standard-silver-sparkle-10148704,1903,671
685,648,1271,0,1919,squier-affinity-telecaster-deluxe-bmm,1919,623
686,592,1327,8,1911,d-angelico-deluxe-dc-le-rus,1903,735
687,656,1263,8,1911,jackson-pro-dk-modern-ash-ht6-bw,1903,607
688,640,1271,0,1911,fender-player-telecaster-hh-mn-tpl-10151203,1911,631
689,600,1319,8,1911,d-angelico-deluxe-dc-sh,1903,719
690,648,1271,8,1911,fender-american-professional-ii-strat-hss-rw-dk-nit,1903,623
691,648,1271,8,1911,fender-70th-anniversary-esquire-2ts,1903,623
692,656,1263,16,1903,schecter-sls-elite-pt-antique-fade-burst,1887,607
693,648,1263,8,1911,fender-player-stratocaster-mn-blk,1903,615
694,600,1319,8,1911,gretsch-guitars-g6636tsl-players-edition-silver-falcon-blk,1903,719
695,624,1287,0,1911,evh-wolfgang-standard-exotic-ms,1911,663
696,656,1263,8,1911,ibanez-rga42ex-bam,1903,607
697,594,1318,0,1903,jackson-king-v-js32-bk-sw,1903,724
698,648,1271,8,1911,fender-american-professional-ii-tele-dlx-rw-dk-nit,1903,623
699,664,1255,0,1919,ibanez-prestige-rgdr4427fx-ntf,1919,591
700,640,1271,0,1911,squier-classic-vibe-60s-stratocaster-10115047,1911,631
701,624,1303,16,1903,jackson-rhoads-rrx24-bk-w-yellow-bevels,1887,679
702,360,591,152,799,gibson-es-339-trans-ebony,647,231
703,320,639,8,951,esp-ltd-aa-600-blks,943,319
704,376,583,176,783,epiphone-sg-standard-ebony,607,207
705,312,647,0,959,esp-ltd-gt-600-blk-glenn-tipton-signature,959,335
706,640,1279,8,1903,prs-s2-custom-24-faded-grey-black-blue-burst-ltd,1895,639
707,624,1295,16,1903,nik-huber-piet-2-tone-sunburst,1887,671
708,613,1271,16,1903,duesenberg-starplayer-tv-sg-10150494,1887,658
709,656,1263,8,1911,fender-signature-strat-jimmie-vaughan-olympic-white,1903,607
710,640,1279,8,1911,charvel-pro-mod-so-cal-24-ht-hh-robins-egg-blu,1903,639
711,640,1271,8,1911,fender-vintera-70-s-tele-custom-frd,1903,631
712,352,615,88,867,slick-sl-52-vsb,779,263
713,632,1287,0,1919,evh-wolfgang-standard-qm-trans-amber,1919,655
714,600,1319,16,1903,gretsch-guitars-electromatic-g5622t-emtc-cb-dc-grg,1887,719
715,616,1303,8,1911,d-angelico-excel-mini-dc-tour-collection-solid-black,1903,687
716,656,1263,8,1911,jackson-js32q-dka-ht-trans-purple-burst,1903,607
717,600,1319,8,1911,gretsch-guitars-g6120t-hr-brian-setzer-hot-rod-cbb,1903,719
718,648,1271,8,1911,fender-american-professional-ii-stratocaster-hss-mn-3ts,1903,623
719,312,647,0,959,esp-ltd-te-401-blks,959,335
720,640,1279,8,1911,fender-vintera-70-s-tele-custom-blk,1903,639
721,320,639,0,959,esp-ltd-h-1007fm-stblk-see-thru-black,959,319
722,608,1263,16,1903,duesenberg-starplayer-tv-vw,1887,655
723,648,1271,8,1911,fender-75th-anniversary-tele-platinum,1903,623
724,640,1279,8,1919,d-angelico-deluxe-atlantic-le-rus,1911,639
725,320,642,8,951,slick-sl-52-bwn,943,322
726,288,671,0,959,esp-ltd-ex-401-sw,959,383
727,640,1279,16,1895,haar-traditional-jm-fiesta-red,1879,639
728,304,655,0,959,ibanez-artcore-am53-srf,959,351
729,648,1271,8,1911,jackson-pro-shadowcaster-rc-prpl-met,1903,623
730,648,1277,0,1918,esp-ltd-mh-1007-evertune-snow-white,1918,629
731,640,1279,0,1919,fender-american-pro-ii-jazzmaster-rw-merc,1919,639
732,648,1271,8,1903,duesenberg-double-cat-ctb,1895,623
733,328,639,0,959,schecter-omen-extreme-7-bch,959,311
734,640,1279,8,1911,jackson-pro-monarkh-sc-satin-black,1903,639
735,648,1271,8,1911,squier-bullet-strat-ht-bk-10110131,1903,623
736,376,583,176,783,epiphone-wilshire-p-90-eb,607,207
737,592,1327,8,1911,gretsch-guitars-g6120tfm-bsnv-brian-setzer-signature,1903,735
738,621,1303,0,1915,esp-ltd-ec-1000-qm-see-thru-purple-sunburst,1915,682
739,664,1247,8,1911,fender-american-performer-mustang-rw-3tsb,1903,583
740,304,655,0,959,esp-ltd-viper-1000-et-qm-see-thru-black-cherry-satin-qm-evertune,959,351
741,322,650,0,959,ibanez-prestige-s6570sk-stb,959,328
742,328,639,8,951,ibanez-mikro-grgm21-wh-10098530,943,311
743,640,1279,8,1911,jackson-x-series-mm-dominion-snwht,1903,639
744,328,639,8,959,schecter-hellraiser-c-7-fr-s-bch,951,311
745,656,1263,0,1919,ibanez-grg220pa1-bkb,1919,607
746,648,1271,8,1911,fender-custom-shop-1950-double-esquire-super-heavy-relic,1903,623
747,624,1303,8,1911,jackson-rhoads-rrx24-bk-w-green-bevels,1903,679
748,656,1263,0,1919,squier-paranormal-cabronita-baritone-tele-ppg-3ts,1919,607
749,640,1279,0,1919,fender-american-pro-ii-jazzmaster-mn-myst-sfg,1919,639
750,624,1295,16,1911,nik-huber-redwood-tigereye-burst-10141534,1895,671
751,320,639,0,959,esp-e-ii-m-ii-fm-see-thru-black,959,319
752,648,1279,8,1911,charvel-pro-mod-socal-style-2-24-2pt-black-ash,1903,631
753,296,663,0,951,gretsch-guitars-g6118t-135-anniversary-two-tone-dc-cg,951,367
754,648,1271,8,1911,fender-player-plus-stratocaster-hss-mn-cmj,1903,623
755,632,1279,0,1911,squier-contemporary-active-jazzmaster-grm,1911,647
756,313,647,0,959,esp-ltd-viper-7-baritone-black-metal-blks-black-satin,959,334
757,624,1295,8,1911,d-angelico-premier-bedford-sh-sb,1903,671
758,608,1311,0,1919,jackson-pro-series-christian-andreu-signature-rhoads-rrt,1919,703
759,624,1295,8,1911,d-angelico-deluxe-mini-dc-rus,1903,671
760,632,1287,8,1911,squier-classic-vibe-70s-jaguar-sfg,1903,655
761,640,1271,0,1911,squier-classic-vibe-60s-stratocaster-lpb,1911,631
762,664,1255,0,1919,ibanez-rgdms8-csm,1919,591
763,664,1255,8,1911,ibanez-mikro-grgm21m-wns,1903,591
764,616,1303,16,1911,ibanez-quest-q54-bkf,1895,687
765,648,1263,0,1911,fender-player-stratocaster-hsh-pf-tbs,1911,615
766,328,631,8,951,ibanez-gio-grg140-sb,943,303
767,680,1247,8,1911,schecter-hellcat-vi-ivyp,1903,567
768,656,1263,8,1911,schecter-c-6-pro-arb,1903,607
769,296,663,8,951,hagstrom-fantomen-tsb,943,367
770,576,1343,8,1911,hagstrom-67-viking-ii-wct,1903,767
771,160,327,8,479,brian-may-special-le-natural,471,167
772,657,1263,8,1911,schecter-banshee-mach-6-fr-s-fob,1903,606
773,680,1239,21,1906,harmony-standard-series-juno-rose,1885,559
774,728,1191,0,1919,gretsch-guitars-g5700-lap-steel-vwt,1919,463
775,328,623,32,919,charvel-joe-duplantier-san-dimas-style-2-hh,887,295
776,608,1303,8,1916,danelectro-63-dano,1908,695
777,648,1271,8,1911,squier-classic-vibe-70s-tele-deluxe-blk,1903,623
778,320,639,0,959,redwood-s-style-3ts-hss,959,319
779,640,1271,8,1911,gretsch-guitars-g2655-cb-jr-vlamb,1903,631
780,320,634,8,959,esp-ltd-eclipse-87-nt-turquoise,951,314
781,642,1278,0,1919,esp-ltd-mh-1000-et-dbsb,1919,636
782,344,615,56,903,ibanez-prestige-az2202a-tfb-10135242,847,271
783,616,1279,8,1911,gretsch-guitars-g2210-streamliner-junior-jet-club-imperial-stain,1903,663
784,304,639,0,959,vintage-icon-v120mrghb,959,335
785,664,1255,8,1911,ibanez-prestige-az2402-pwf,1903,591
786,656,1263,0,1919,fender-player-lead-ii-crt,1919,607
787,640,1279,16,1903,prs-s2-custom-24-faded-grey-black-purple-burst,1887,639
788,616,1303,8,1911,ibanez-artcore-as7312-tcd,1903,687
789,616,1303,0,1919,yamaha-revstar-rss20flg-flash-green,1919,687
790,336,631,0,959,schecter-c-8-deluxe-swh,959,295
791,664,1255,8,1911,sterling-by-music-man-john-petrucci-majesty-7-adr,1903,591
792,336,626,32,927,vintage-icon-v6mrssb,895,290
793,325,631,8,951,slick-sl-55-sg,943,306
794,624,1295,16,1903,nik-huber-piet-turquoise-green-10147049,1887,671
795,640,1279,0,1919,squier-40th-anniversary-jazzmaster-gold-edition-lpb,1919,639
796,637,1287,21,1903,prs-se-mira-vc,1882,650
797,592,1311,8,1903,gretsch-guitars-original-g6136t-59-falcon-lake-placid-blue,1895,719
798,288,666,0,943,esp-ltd-signature-alexi-200-black-alexi-laiho-signature,943,378
799,664,1255,0,1919,evh-striped-series-78-eruption,1919,591
800,632,1279,0,1911,gretsch-guitars-g5655tg-center-block-jr-cdg,1911,647
801,648,1271,0,1919,fender-american-vintage-ii-1975-telecaster-custom-blk,1919,623
802,321,641,0,958,ibanez-sa260fm-tgb,958,320
803,576,1343,2,1916,esp-ltd-max-200-rpr,1914,767
804,648,1271,8,1911,fender-player-plus-stratocaster-mn-olp,1903,623
805,616,1303,0,1919,yamaha-revstar-rss20htm-hot-merlot,1919,687
806,656,1263,8,1911,jackson-pro-soloist-sl2q-trans-purple,1903,607
807,600,1319,0,1919,gretsch-guitars-electromatic-g5422g-12-wlnt,1919,719
808,648,1271,16,1895,epiphone-les-paul-modern-faded-pelham-blue,1879,623
809,616,1303,0,1919,yamaha-revstar-rse20swb-swift-blue,1919,687
810,648,1271,8,1911,charvel-pro-mod-san-dimas-style-1-neon-pink-ash,1903,623
811,648,1271,0,1919,ibanez-sml721-rgc,1919,623
812,648,1271,0,1919,jackson-x-series-soloist-slx-dx-tiger-jungle-camo,1919,623
813,664,1255,0,1919,ibanez-rga622xh-wh,1919,591
814,664,1255,8,1911,schecter-banshee-mach-7-eb-10128745,1903,591
815,648,1263,0,1911,fender-albert-hammond-jr-stratocaster-pr-owh,1911,615
816,664,1255,8,1911,jackson-slatx8-qm-ms-tr-blk-brst,1903,591
817,624,1295,8,1911,jackson-pro-rr24q-trans-purple,1903,671
818,640,1279,8,1911,hagstrom-super-swede-ltd-tiger-burst,1903,639
819,656,1255,16,1895,gibson-custom-shop-63-sg-special-reissue-vos,1879,599
820,384,575,192,767,epiphone-1959-les-paul-standard-outfit-adcb,575,191
821,648,1271,8,1911,squier-contemporary-stratocaster-special-hh-shpp,1903,623
822,648,1271,32,1911,hagstrom-pat-smear-signature,1879,623
823,640,1271,0,1911,fender-player-stratocaster-hss-pf-blk,1911,631
824,640,1279,0,1919,yamaha-pacifica-112v-vw,1919,639
825,648,1271,8,1911,sterling-by-music-man-mariposa-imperial-white,1903,623
826,640,1279,8,1911,gretsch-guitars-g5655t-cb-jr-csg,1903,639
827,648,1255,9,1903,schecter-van-nuys-traditional-gna,1894,607
828,656,1263,8,1911,schecter-reaper-7-elite-multiscale-bloodburst,1903,607
829,648,1271,0,1919,fender-vintera-70-s-tele-lpb,1919,623
830,648,1271,8,1911,squier-classic-vibe-60s-esquire-custom-lpb,1903,623
831,640,1279,0,1919,evh-5150-standard-slime-green,1919,639
832,648,1271,8,1911,schecter-damien-platinum-6-fr-s-satin-black,1903,623
833,312,647,0,959,paoletti-stratospheric-loft-sss-05-20-firemist-purple,959,335
834,608,1303,8,1911,jackson-rhoads-rr24x-black-camo,1903,695
835,648,1271,0,1919,charvel-pro-mod-san-dimas-sc1-platinum-pink,1919,623
836,656,1263,8,1903,schecter-hellraiser-c-1-fr-bch,1895,607
837,648,1271,8,1911,hagstrom-ultra-max-special-blockbuster-yellow-metallic,1903,623
838,640,1279,24,1911,prs-custom-24-purple-iris,1887,639
839,640,1279,8,1911,fender-player-plus-telecaster-mn-acar,1903,639
840,648,1271,8,1911,fender-player-plus-stratocaster-pf-ospk,1903,623
841,640,1279,16,1903,haar-traditional-t-aged-orange-seethrough-10144814,1887,639
842,310,647,16,959,duesenberg-starplayer-tv-mike-campbell-mc,943,337
843,672,1247,16,1911,ibanez-az427p1pb-ckb,1895,575
844,656,1263,224,1695,guild-x-175-manhattan-special-gold-coast,1471,607
845,328,639,0,959,schecter-hellraiser-c-1-fr-stpb,959,311
846,641,1278,0,1917,esp-e-ii-horizon-nt-ii-stbcsb,1917,637
847,320,609,72,883,esp-usa-eclipse-sbm-emg,811,289
848,624,1287,8,1903,gretsch-guitars-g5220-electronatic-jet-bt-jde-gry,1895,663
849,328,645,0,951,ibanez-gio-grx70qa-trb,951,317
850,624,1295,0,1919,gretsch-guitars-g6659tg-cg,1919,671
851,606,1311,0,1919,duesenberg-caribou-butterscotch-blonde,1919,705
852,616,1295,8,1903,gretsch-guitars-g6659tg-player-s-edition-broadkaster-jr-cb,1895,679
853,600,1317,8,1919,d-angelico-excel-ss-tour-slate-blue,1911,717
854,648,1279,8,1911,epiphone-jerry-cantrell-wino-les-paul-custom,1903,631
855,288,671,8,951,guild-starfire-i-sc-scw-b-stock,943,383
856,352,611,56,903,ibanez-rgib21-bk-iron-label,847,259
857,656,1271,16,1911,duesenberg-caribou-narvik-blue,1895,615
858,640,1279,0,1911,squier-classic-vibe-60-s-custom-telecaster-3ts,1911,639
859,656,1263,8,1911,schecter-silver-mountain-c-7-multiscale,1903,607
860,648,1279,24,1895,maybach-lester-gold-rush-57-aged,1871,631
861,600,1327,8,1911,gretsch-guitars-g6119-et-tennessee-rose-pro-player-s-edition-dcs,1903,727
862,336,639,0,959,schecter-omen-7-wsn,959,303
863,320,637,0,959,esp-ltd-m-1-custom-87-dmb,959,317
864,648,1271,16,1903,fender-custom-shop-red-hot-strat-super-heavy-relic,1887,623
865,648,1271,0,1919,squier-40th-anniversary-stratocaster-gold-edition-rrm,1919,623
866,656,1263,0,1919,ibanez-frm300-pr-paul-gilbert,1919,607
867,648,1271,0,1919,fender-jv-modified-60s-custom-telecaster-fmg-rw,1919,623
868,584,1327,8,1903,gretsch-guitars-streamliner-g2622t-gnmtl,1895,743
869,672,1247,0,1919,squier-paranormal-cyclone-car,1919,575
870,608,1311,0,1919,ibanez-amh90-bk,1919,703
871,640,1271,8,1911,fender-vintera-60-s-tele-mod-sfmg,1903,631
872,352,607,88,871,slick-sl-50-ba,783,255
873,288,671,8,951,guild-x-350-stratford-scarlet-red,943,383
874,656,1263,0,1919,squier-paranormal-cabronita-baritone-tele-ppg-sfg,1919,607
875,640,1271,0,1919,fender-american-ultra-telecaster-mn-mbst,1919,631
876,648,1263,8,1911,epiphone-jerry-cantrell-prophecy-les-paul-custom,1903,615
877,616,1303,0,1919,yamaha-revstar-rss02tbl-black,1919,687
878,340,623,54,903,ibanez-premium-rg1121pb-cif,849,283
879,622,1303,0,1919,esp-ltd-deluxe-ec-1000t-ctm-vintage-gold-satin,1919,681
880,384,575,176,783,epiphone-prophecy-sg-red-tiger-aged,607,191
881,632,1282,0,1919,gretsch-guitars-electromatic-g5232t-double-jet-ft-dcm,1919,650
882,656,1263,8,1911,schecter-nick-johnston-traditional-as-10133919,1903,607
883,640,1279,8,1911,gretsch-guitars-streamliner-g2655t-p90-mint-metallic,1903,639
884,640,1279,8,1911,fender-j-mascis-telecaster-spk-blu,1903,639
885,320,634,8,959,esp-ltd-m-ht-black-metal-blks,951,314
886,656,1263,8,1911,jackson-mj-series-dinky-dkr-stealth-satin-black,1903,607
887,336,655,8,959,schecter-solo-ii-custom-tbbn,951,319
888,656,1263,16,1903,duesenberg-alliance-joe-walsh-gb-10131981,1887,607
889,648,1271,8,1911,fender-american-professional-ii-telecaster-dlx-rw-merc,1903,623
890,640,1279,0,1919,squier-affinity-jazzmaster-lpb,1919,639
891,336,655,0,959,maybach-lester-cherry-lane-58-aged,959,319
892,320,631,0,959,harmony-standard-series-juno-champagne,959,311
893,656,1263,0,1919,ibanez-premium-rgt1220pb-abs,1919,607
894,573,1354,0,1911,esp-ltd-signature-kh-v-mgo,1911,781
895,592,1327,0,1919,gretsch-guitars-streamliner-g2622t-p90-gunmetal,1919,735
896,632,1287,8,1911,gretsch-guitars-streamliner-g2215-p90-jr-jet-sng,1903,655
897,600,1319,16,1895,d-angelico-deluxe-dc-sbb,1879,719
898,648,1271,0,1919,fender-player-telecaster-mn-pacific-peach,1919,623
899,664,1255,8,1910,schecter-sun-valley-fr-satin-black,1902,591
900,648,1271,0,1919,squier-affinity-strat-3tsb,1919,623
901,616,1311,0,1911,danelectro-59-m-nos-modified-10075392,1911,695
902,624,1279,24,1903,peavey-hp2-tremolo-black,1879,655
903,275,687,0,958,esp-ltd-snakebyte-blks-james-hetfield-signature,958,412
904,664,1255,0,1919,ibanez-rg8870-bre,1919,591
905,648,1271,0,1919,squier-affinity-telecaster-deluxe-cfm,1919,623
906,288,671,8,951,guild-starfire-iv-antique-burst,943,383
907,656,1263,8,1917,charvel-pro-mod-dk-22-2pt-nat-mah-walnut,1909,607
908,640,1279,8,1911,ibanez-yy10-sgs-yvette-young,1903,639
909,648,1271,0,1919,schecter-omen-extreme-6-stbk,1919,623
910,664,1255,8,1911,jackson-pro-series-misha-mansoor-juggernaut-et7-gbl,1903,591
911,656,1263,16,1903,gibson-custom-shop-firebird-custom,1887,607
912,656,1263,8,1911,jackson-pro-dk-modern-ht6-ms-swht,1903,607
913,304,663,0,959,guild-starfire-vi-scwh,959,359
914,632,1279,0,1911,evh-wolfgang-standard-exotic-spalted-maple,1911,647
915,648,1279,8,1903,squier-40th-anniversary-vintage-edition-stratocaster-ssob,1895,631
916,648,1263,0,1919,jackson-x-series-soloist-sl3x-dx-yellow-crackle,1919,615
917,648,1271,0,1919,fender-player-plus-stratocaster-pf-acar,1919,623
918,648,1271,0,1919,charvel-pro-mod-san-dimasl-style-1-fr-m-chameleon-10148688,1919,623
919,304,655,8,951,ibanez-artcore-ag95qa-dbs-10110838,943,351
920,590,1327,8,1911,gretsch-guitars-g2622t-cb-dc-imprl,1903,737
921,601,1306,8,1919,danelectro-59-divine-fc,1911,705
922,648,1271,8,1911,evh-5150-dlx-black-burst,1903,623
923,325,644,0,951,ibanez-psm10-bk-paul-stanley-mikro,951,319
924,664,1247,8,1903,jackson-dinky-dkaf7-ms-smh-10141018,1895,583
925,322,634,0,959,esp-e-ii-horizon-nt-7b-hs-blks,959,312
926,664,1247,0,1911,fender-american-performer-mustang-rw-vwt,1911,583
927,376,583,176,783,epiphone-les-paul-classic-ebony,607,207
928,640,1271,0,1911,squier-classic-vibe-50s-stratocaster-wbl-10115044,1911,631
929,664,1255,8,1911,charvel-pro-mod-dk-24-red-ash,1903,591
930,656,1263,0,1919,fender-yngwie-malmsteen-stratocaster-vwh,1919,607
931,656,1255,8,1903,jackson-pro-signature-misha-mansoor-juggernaut-ht6,1895,599
932,648,1271,8,1911,fender-signature-strat-eric-clapton-ptr,1903,623
933,648,1271,8,1911,fender-american-professional-ii-stratocaster-hss-rw-merc,1903,623
934,648,1271,8,1903,fender-custom-shop-ancho-pablano-strat-super-heavy-relic,1895,623
935,648,1271,0,1911,fender-player-telecaster-mn-pwt,1911,623
936,688,1231,8,1911,schecter-robert-smith-ultracure-bp,1903,543
937,600,1319,0,1919,duesenberg-paloma-catalina-harbour-green,1919,719
938,640,1279,8,1911,squier-toronado-3ts,1903,639
939,632,1279,16,1903,prs-se-dgt-gold-top,1887,647
940,318,647,0,959,redwood-relics-60s-s-style-blk,959,329
941,320,631,8,947,hagstrom-ultra-swede-black-gloss,939,311
942,592,1319,2,1919,eastman-thinline-t59-v,1917,727
943,568,1351,8,1919,jackson-js32t-star-gus-g-sign-ivory,1911,783
944,648,1271,8,1911,squier-mini-strat-dkr,1903,623
945,656,1263,0,1919,jackson-chris-broderick-pro-soloist-7p-gblk,1919,607
946,616,1295,0,1911,jackson-pro-series-rrt-5-blk-gld,1911,679
947,592,1319,8,1911,gretsch-guitars-electromatic-g5622t-lh-emtc-cb-dc-grg,1903,727
948,632,1287,0,1919,gretsch-guitars-streamliner-g2215-p90-jr-jet-hv-shlpnk,1919,655
949,352,611,73,879,esp-usa-m2-fr-e-b-ogblk-emg,806,259
950,648,1271,0,1919,squier-40th-anniversary-telecaster-gold-edition-shw,1919,623
951,648,1271,9,1903,schecter-sls-elite-c-1-evil-twin-sb,1894,623
952,312,639,8,959,redwood-relics-60s-s-style-hss-car,951,327
953,632,1287,8,1911,squier-classic-vibe-70s-jaguar-blk,1903,655
954,664,1255,0,1919,jackson-american-series-soloist-sl3-platinum-pearl,1919,591
955,728,1191,0,1919,gretsch-guitars-g5700-lap-steel-bdwy-jde,1919,463
956,328,639,8,951,ibanez-sa260fm-vls,943,311
957,656,1263,0,1919,charvel-pro-mod-dk24-hh-2pt-trans-black-burst,1919,607
958,656,1268,16,1895,yamaha-sg-1802-gt,1879,612
959,640,1279,8,1903,eastman-sb59-v-rb,1895,639
960,320,639,8,951,danelectro-64xt-da,943,319
961,648,1271,8,1911,jackson-dinky-dk2xrht-snow-white,1903,623
962,320,639,56,903,ibanez-artcore-as73g-rgf,847,319
963,648,1271,8,1911,hagstrom-ultra-swede-worn-demin-burst,1903,623
964,576,1343,8,1911,hagstrom-viking-blk,1903,767
965,336,623,0,951,jackson-dinky-dkaf8-ms-smh-10117736,951,287
966,616,1279,0,1895,duesenberg-starplayer-tv-custom-dtv-cm-bk-10071569,1895,663
967,648,1263,8,1911,fender-standard-stratocaster-mn-3-ts,1903,615
968,624,1311,8,1919,jackson-pro-series-rr3-ivr-blk,1911,687
969,664,1255,8,1911,schecter-banshee-mach-7-fr-s-fob,1903,591
970,664,1255,8,1911,squier-classic-vibe-60s-mustang-vwt,1903,591
971,648,1271,0,1919,squier-affinity-strat-mn-lpb,1919,623
972,640,1287,80,1839,duesenberg-alliance-tom-bukovac,1759,647
973,632,1287,16,1911,maybach-lester-honey-pie-59-aged,1895,655
974,328,631,0,959,caparison-dellinger-ii-fx-am-brnm,959,303
975,296,663,0,959,gibson-custom-shop-explorer-custom-special-10118997,959,367
976,648,1271,8,1911,jackson-dinky-dk3xr-neon-green,1903,623
977,624,1295,8,1911,squier-paranormal-offset-tele-mpg-shp,1903,671
978,640,1279,8,1911,fender-vintera-60-s-tele-bigsby-3ts,1903,639
979,664,1255,8,1903,schecter-sun-valley-fr-gw,1895,591
980,296,655,8,951,eastman-thinline-t486-gb-goldburst-10151338,943,359
981,648,1271,8,1911,hagstrom-ultra-swede-esn-wild-cherry-transparent-10131265,1903,623
982,648,1279,16,1911,haar-traditional-t-chestnut-burst,1895,631
983,600,1319,8,1911,gretsch-guitars-streamliner-g2410tg-single-barrel,1903,719
984,656,1263,8,1911,jackson-soloist-sl3x-dxm-satin-black,1903,607
985,664,1255,0,1919,ibanez-prestige-az2204n-bk,1919,591
986,277,666,8,951,godin-5th-avenue-kingpin-cw-10019915,943,389
987,624,1287,16,1903,nik-huber-piet-turquoise-green,1887,663
988,648,1271,0,1919,charvel-pro-mod-san-dimasl-style-1-fr-m-chameleon,1919,623
989,656,1263,0,1919,ibanez-azes40-bk,1919,607
990,640,1271,8,1911,fender-player-telecaster-mn-blk,1903,631
991,656,1263,16,1903,gibson-custom-shop-firebird-custom-10147570,1887,607
992,600,1319,8,1911,gretsch-guitars-electromatic-g5622-emtc-cb-dc-speyside,1903,719
993,624,1295,8,1911,ibanez-artcore-expressionist-am93qm-jbb,1903,671
994,624,1295,0,1919,ibanez-iron-label-xptb720-bkf,1919,671
995,648,1271,0,1919,ibanez-gsa60qa-trb,1919,623
996,635,1287,0,1919,esp-ltd-te-1000-sw,1919,652
997,616,1295,8,1911,ibanez-gb10se-bs-george-benson,1903,679
998,640,1279,16,1903,gibson-1959-les-paul-standard-reissue,1887,639
999,632,1263,16,1903,epiphone-les-paul-standard-60s-ebony,1887,631
1000,656,1263,8,1911,ibanez-gio-grgr131ex-bkf,1903,607
1001,672,1247,8,1911,schecter-damien-platinum-9-sbk,1903,575
1002,288,671,0,959,esp-ltd-vulture-blks-james-hetfield-signature,959,383
1003,640,1271,8,1911,fender-player-telecaster-mn-3ts,1903,631
1004,320,639,8,951,esp-ltd-signature-george-lynch-gl-200mt,943,319
1005,648,1255,16,1903,ibanez-s521-bbs,1887,607
1006,656,1263,8,1911,schecter-reaper-6-fr-sskyb,1903,607
1007,584,1335,0,1919,evh-striped-series-shark,1919,751
1008,608,1311,16,1903,gibson-murphy-lab-1964-es-335-ultra-light-aged-10150804,1887,703
1009,656,1263,0,1919,jackson-x-series-soloist-slx-dx-manalishi-green,1919,607
1010,648,1271,8,1911,fender-american-professional-ii-stratocaster-rw-3ts,1903,623
1011,312,647,8,956,guild-bluesbird-bk-10147682,948,335
1012,640,1271,0,1911,squier-classic-vibe-60s-stratocaster-car,1911,631
1013,322,639,0,959,esp-ltd-kh-602-psp-10120183,959,317
1014,312,639,8,951,prs-se-santana-sy-10109888,943,327
1015,320,639,0,959,schecter-hellraiser-c-1-fr-wh,959,319
1016,648,1271,8,1911,fender-stevie-ray-vaughan-stratocaster,1903,623
1017,648,1271,8,1911,fender-signature-ritchie-blackmore-ow,1903,623
1018,648,1279,16,1903,gretsch-guitars-electromatic-g5222-double-jet-jde-gry,1887,631
1019,648,1271,8,1911,schecter-damien-6-fr-sbk,1903,623
1020,640,1279,24,1903,friedman-metro-d-metallic-blue,1879,639
1021,296,655,8,951,eastman-thinline-t486-gb-goldburst,943,359
1022,632,1287,0,1911,gretsch-guitars-g5230t-jet-ft-airline-silver,1911,655
1023,648,1271,0,1919,schecter-omen-6-vwht,1919,623
1024,624,1287,16,1903,prs-s2-mccarty-594-singlecut-msb,1887,663
1025,645,1271,8,1911,fender-player-stratocaster-hsh-pf-silver,1903,626
1026,314,647,0,959,esp-ltd-phoenix-black-metal-blks,959,333
1027,328,583,96,863,vintage-v100afd-10149978,767,255
1028,320,639,0,959,esp-ltd-h3-1000fr-stblksb,959,319
1029,656,1271,16,1895,epiphone-les-paul-modern-figured-magma-orange-fade,1879,615
1030,360,599,176,783,gibson-es-335-satin-vintage-burst-10151868,607,239
1031,648,1263,8,1903,gretsch-guitars-g6134-58-penguin,1895,615
1032,316,639,32,927,esp-ltd-ec-1000-fr-stblk-see-thru-black,895,323
1033,640,1287,16,1903,prs-s2-mccarty-594-singlecut-ev-10146217,1887,647
1034,288,671,8,954,guild-x-175b-manhattan-special-mb,946,383
1035,648,1271,8,1911,fender-player-telecaster-pf-pwt,1903,623
1036,288,671,0,959,esp-ltd-alexi-ripped-sawtooth-purple-fade-satin,959,383
1037,656,1263,8,1911,squier-super-sonic-wppg-grm,1903,607
1038,648,1271,8,1911,fender-player-plus-stratocaster-hss-pf-blb,1903,623
1039,648,1263,8,1911,hagstrom-ultra-max-black-satin,1903,615
1040,656,1279,24,1903,prs-se-mark-holcomb-hbb,1879,623
1041,640,1271,8,1911,fender-american-performer-jazzmaster-rw-slpb,1903,631
1042,648,1271,8,1911,fender-custom-shop-55-bone-tone-stratocaster,1903,623
1043,672,1247,8,1911,fender-kurt-cobain-jagstang-frd,1903,575
1044,157,319,0,471,gibson-1957-les-paul-reissue-vos-10139123,471,162
1045,648,1263,16,1903,suhr-classic-t-trans-butterscotch,1887,615
1046,0,959,0,959,esp-ltd-ps-1000-blusp,959,959
1047,288,631,0,959,esp-usa-eclipse-ch-blk-emg,959,343
1048,350,607,112,847,yamaha-pacifica-311h-vw,735,257
1049,648,1271,8,1911,charvel-pro-mod-socal-style-2-24-2pt-natural,1903,623
1050,648,1271,16,1911,duesenberg-starplayer-tv-custom-cm-bk,1895,623
1051,640,1279,0,1919,yamaha-pacifica-112vm-sp,1919,639
1052,656,1263,8,1911,charvel-dk-22-sss-2pt-electric-blue,1903,607
1053,621,1303,0,1919,esp-ltd-f-black-metal-blks-black-satin,1919,682
1054,672,1247,0,1919,jackson-pro-sl7-jeff-loomis-soloist-sbk,1919,575
1055,616,1303,8,1911,yamaha-revstar-rsp02tssb-sunset-burst,1903,687
1056,608,1319,16,1903,gibson-custom-shop-1961-es-335-vos-sixties-cherry-10150474,1887,711
1057,320,645,8,951,guild-aristocrat-hh-trans-black,943,325
1058,286,671,0,954,guild-x-175-manhattan-special-fjord-green,954,385
1059,648,1279,16,1911,haar-traditional-t-aged-olympic-white,1895,631
1060,632,1278,24,1903,duesenberg-alliance-dave-baksh-paloma,1879,646
1061,618,1295,0,1919,ibanez-artcore-expressionist-am93qm-ays,1919,677
1062,648,1271,8,1911,schecter-damien-platinum-6,1903,623
1063,648,1271,8,1911,fender-american-professional-ii-stratocaster-hss-mn-owt,1903,623
1064,648,1263,16,1895,epiphone-sg-standard-61-vintage-cherry,1879,615
1065,616,1303,0,1919,ibanez-amh90-iv,1919,687
1066,296,663,8,951,guild-starfire-iv-st-12-sm,943,367
1067,656,1263,8,1911,jackson-mj-series-soloist-sl2-snow-white,1903,607
1068,648,1271,8,1911,fender-american-professional-ii-telecaster-rw-3tsb,1903,623
1069,648,1263,16,1903,slick-sl-51-vsb,1887,615
1070,592,1319,8,1903,gretsch-guitars-streamliner-g2420-wlnt,1895,727
1071,680,1231,258,1655,guild-starfire-vi-an-b-stock,1397,551
1072,632,1271,24,1911,prs-se-custom-24-08-vs,1887,639
1073,656,1263,8,1911,ibanez-jivajr-dse-nita-strauss,1903,607
1074,648,1271,0,1919,charvel-pro-mod-san-dimas-sc1-satin-burgundy-mist,1919,623
1075,592,1327,0,1919,gretsch-guitars-streamliner-g2410tg-ocean-turquoise,1919,735
1076,600,1319,16,1887,ibanez-signature-lgb30-vys-george-benson,1871,719
1077,624,1295,16,1903,jackson-rhoads-rr-pro-gbk,1887,671
1078,656,1268,0,1919,esp-e-ii-m-ii-7b-baritone-evertune-gnsp,1919,612
1079,656,1263,16,1903,slick-sl-50-bst,1887,607
1080,632,1287,0,1911,fender-player-jaguar-pf-db-daphne-blue,1911,655
1081,664,1255,8,1911,ibanez-mar10-lmm-mario-camarena,1903,591
1082,616,1303,16,1911,d-angelico-premier-mini-dc-fr,1895,687
1083,605,1314,0,1919,danelectro-59x-light-aqua,1919,709
1084,640,1279,8,1911,d-angelico-deluxe-atlantic-vs,1903,639
1085,160,319,0,479,maybach-albatroz-65-aged-vintage-cream-10122726,479,159
1086,648,1263,0,1911,fender-player-stratocaster-hsh-pf-tbs-10142312,1911,615
1087,648,1271,8,1911,fender-american-professional-ii-tele-dlx-mn-myst-sfg,1903,623
1088,656,1263,8,1911,ibanez-gio-gsa60-bkn,1903,607
1089,656,1271,0,1917,esp-ltd-deluxe-h3-1000-see-thru-black-cherry,1917,615
1090,656,1255,8,1911,schecter-keith-merrow-km-6-mk-iii-artist-blue-crimson,1903,599
1091,656,1263,8,1911,charvel-mj-rick-graham-dk24-2pt-cm,1903,607
1092,656,1263,16,1903,schecter-sc865-traditional-pro-tpb,1887,607
1093,656,1263,8,1911,caparison-horus-m3-ef-am,1903,607
1094,656,1263,8,1911,ibanez-gio-grx70qa-tks,1903,607
1095,384,575,176,783,kramer-the-84-the-illusionist,607,191
1096,640,1271,0,1911,squier-classic-vibe-50s-telecaster-btb,1911,631
1097,592,1327,8,1911,hagstrom-super-viking-taylor-york,1903,735
1098,640,1279,8,1911,d-angelico-premier-atlantic-sb,1903,639
1099,605,1314,0,1914,esp-ltd-ex-7-baritone-black-metal-black-satin,1914,709
1100,664,1255,8,1911,ibanez-rg420hpfm-brg,1903,591
1101,640,1271,8,1911,slick-sl-52-bk,1903,631
1102,285,671,0,959,vintage-reissued-vsa500w,959,386
1103,616,1303,8,1911,jackson-warrior-js32-snwh-10147599,1903,687
1104,328,655,8,951,eastman-juliet-p90-vr,943,327
1105,648,1271,8,1911,fender-american-professional-ii-strat-hss-mn-ssb,1903,623
1106,360,599,8,951,hoefner-shorty-red,943,239
1107,621,1303,0,1911,esp-ltd-deluxe-f-1001-violet-andromeda-satin,1911,682
1108,632,1279,0,1911,evh-wolfgang-standard-matte-army-drap,1911,647
1109,648,1271,0,1911,fender-playerstratocaster-hsh-pf-bcr,1911,623
1110,616,1287,0,1919,eastman-t-484-classic,1919,671
1111,640,1279,8,1911,sterling-by-music-man-john-petrucci-jp60-mystic-dream,1903,639
1112,648,1271,8,1911,squier-classic-vibe-70s-stratocaster-nat,1903,623
1113,640,1279,0,1919,evh-5150-series-deluxe-qm-purple-daze,1919,639
1114,672,1247,8,1911,ibanez-rg8-wh,1903,575
1115,592,1327,8,1911,d-angelico-excel-dc-vnat,1903,735
1116,656,1263,8,1911,jackson-dinky-js24-dka-m-dx-black-stain,1903,607
1117,664,1247,0,1911,jackson-pro-series-misha-mansoor-juggernaut-ht7-bl-sky-br,1911,583
1118,320,639,8,951,godin-stadium-ht-havana-brown-mn,943,319
1119,640,1271,0,1911,fender-player-telecaster-hh-mn-tpl,1911,631
1120,656,1271,24,1895,sandberg-forty-eight-sg-sa,1871,615
1121,376,583,176,783,epiphone-les-paul-junior-vintage-sunburst,607,207
1122,640,1279,8,1911,schecter-pt-pro-trans-blue-burst,1903,639
1123,640,1279,16,1911,duesenberg-starplayer-tv-bk,1895,639
1124,328,631,0,959,gibson-les-paul-studio-wine-red-10113961,959,303
1125,640,1271,0,1911,squier-classic-vibe-50s-telecaster-wbl-10150250,1911,631
1126,328,631,24,935,gibson-les-paul-deluxe-70s-cherry-sunburst,911,303
1127,654,1271,24,1903,redwood-s-style-classic-rw-car,1879,617
1128,648,1271,0,1911,squier-classic-vibe-70s-stratocaster-owt,1911,623
1129,624,1295,8,1903,d-angelico-deluxe-bedford-sh-le-rus,1895,671
1130,640,1271,0,1911,gretsch-guitars-g5135cvt-ps-patrick-stump-signature-stump-o-matic,1911,631
1131,640,1279,8,1911,fender-player-plus-telecaster-mn-3ts,1903,639
1132,344,619,56,903,ibanez-rg421hpfm-brg,847,275
1133,640,1279,8,1903,epiphone-les-paul-custom-koa-limited-edition,1895,639
1134,288,671,8,951,guild-starfire-i-dc-chr,943,383
1135,328,631,0,951,schecter-c-7-deluxe-10080896,951,303
1136,648,1271,0,1911,jackson-dinky-dk2xr-snow-white,1911,623
1137,13,935,0,959,heritage-custom-shop-core-collection-h-150-dark-cherry-sunb,959,922
1138,664,1258,0,1914,esp-ltd-deluxe-h3-1007-baritone,1914,594
1139,328,631,0,959,jackson-dinky-js32-dka-m-gbk,959,303
1140,296,663,8,951,hagstrom-fantomen-blk-10132250,943,367
1141,664,1271,16,1903,slick-sl-54-bk,1887,607
1142,328,639,8,959,slick-sl-54-sb,951,311
1143,632,1287,16,1911,prs-private-stock-modern-eagle-v,1895,655
1144,648,1271,0,1911,fender-player-stratocaster-hss-floyd-pf-3tsb,1911,623
1145,584,1335,8,1911,hagstrom-viking-white,1903,751
1146,328,623,8,951,gibson-1961-sg-standard-reissue-v-o-s-10151865,943,295
1147,584,1335,8,1911,gretsch-guitars-g6636-pro-richard-fortus-signature-falcon-blk,1903,751
1148,632,1263,16,1903,schecter-synyster-custom-s-fr-10102994,1887,631
1149,584,1335,0,1919,gretsch-guitars-g5420t-electromatic-classic-org,1919,751
1150,328,627,8,951,esp-ltd-sh-7et-fm-stp,943,299
1151,664,1255,0,1919,ibanez-prestige-az2204n-awd,1919,591
1152,648,1271,16,1911,redwood-s-style-classic-hss-mn-blk,1895,623
1153,640,1279,16,1911,maybach-lester-pelham-blue-90-aged-10092616,1895,639
1154,312,647,0,959,esp-ltd-bw-1-evertune-stblkf-ben-weinman-signature,959,335
1155,624,1295,8,1911,d-angelico-premier-bedford-sh-bf,1903,671
1156,640,1271,8,1911,hagstrom-ultra-swede-burgundy-burst,1903,631
1157,616,1303,8,1911,d-angelico-deluxe-mini-dc-bb,1903,687
1158,648,1271,0,1919,charvel-sean-long-signature-pm-st1-gloss-black,1919,623
1159,320,642,0,959,esp-ltd-signature-kh202-blk-kirk-hammett,959,322
1160,344,618,56,903,ibanez-rg421msp-tsp,847,274
1161,656,1271,16,1903,friedman-vintage-t-black-10121241,1887,615
1162,632,1287,8,1911,fender-vintera-60-s-jaguar-3ts,1903,655
1163,656,1271,8,1903,yamaha-sg-1820-bl,1895,615
1164,360,583,8,951,bohemian-oil-can-guitar-bg25msh,943,223
1165,320,615,24,935,epiphone-slash-les-paul-standard-anaconda-burst,911,295
1166,648,1271,8,1911,fender-vintera-50-s-tele-mod-dnb,1903,623
1167,328,631,8,951,g-l-fullerton-deluxe-asat-classic-lpb,943,303
1168,656,1263,8,1911,schecter-banshee-gt-fr-scb,1903,607
1169,648,1271,0,1919,fender-american-professional-ii-stratocaster-hss-rw-3ts,1919,623
1170,632,1279,0,1911,evh-wolfgang-standard-qm-tahiti-night,1911,647
1171,344,607,88,863,slick-sl-52-sg,775,263
1172,344,618,56,895,ibanez-lhm1-luke-hoskin-tgg-10149787,839,274
1173,640,1271,16,1911,sandberg-california-st-ii-jam-red-hcr,1895,631
1174,656,1287,8,1919,squier-bullet-strat-ht-hss-bk,1911,631
1175,270,687,6,957,esp-signature-james-hetfield-snakebyte-blks,951,417
1176,656,1255,0,1919,schecter-sls-elite-c-1-black-fade-burst,1919,599
1177,288,671,8,951,hagstrom-tremar-hj-500,943,383
1178,624,1303,8,1911,d-angelico-premier-bedford-oxb,1903,679
1179,620,1311,0,1914,esp-ltd-ec-1000t-ctm-stbc-see-thru-black-cherry,1914,691
1180,648,1271,0,1911,fender-american-performer-tele-mn-vwt,1911,623
1181,640,1279,8,1911,sterling-by-music-man-sr30-stealth-black,1903,639
1182,640,1279,0,1919,fender-american-vintage-ii-1957-stratocaster-2tsb,1919,639
1183,616,1305,0,1919,esp-e-ii-eclipse-rdb,1919,689
1184,640,1271,0,1919,fender-american-ultra-telecaster-rw-ultrbst,1919,631
1185,646,1271,0,1917,esp-ltd-deluxe-mh-1000-baritone-blks,1917,625
1186,632,1279,0,1911,squier-contemporary-active-jazzmaster-sfp,1911,647
1187,632,1287,0,1919,gretsch-guitars-g2655-cb-jr-mdsph,1919,655
1188,320,639,0,954,prs-se-mark-holcomb-svn,954,319
1189,648,1271,0,1919,fender-kingfish-telecaster-deluxe-msnt,1919,623
1190,640,1295,16,1895,danelectro-59x-cr,1879,655
1191,648,1263,1,1911,jackson-jackson-x-series-adrian-smith-sdxm-fb-mn-sw,1910,615
1192,320,639,0,959,g-l-fullerton-deluxe-asat-classic-btr,959,319
1193,648,1263,8,1911,fender-vintera-70-s-tele-deluxe-moc,1903,615
1194,660,1259,0,1919,duesenberg-fairytale-lapsteel-split-king-ivory-black,1919,599
1195,656,1263,8,1911,ibanez-ps1cm-paul-stanley-signature,1903,607
1196,344,617,56,903,ibanez-prestige-rg5170g-svf-10132009,847,273
1197,328,631,0,951,ibanez-rg550-rf-genesis-collection,951,303
1198,320,615,24,935,epiphone-billie-joe-armstrong-les-paul-junior-classic-white,911,295
1199,312,647,8,959,esp-e-ii-eclipse-blks-10140676,951,335
1200,648,1263,0,1911,fender-jimmy-page-tele-mirror-rw-wbl,1911,615
1201,344,615,64,895,esp-usa-m-iii-gt-fm-m-tesb-duncan,831,271
1202,312,623,8,951,gibson-les-paul-standard-50s-heritage-cherry-sunburst,943,311
1203,637,1276,16,1899,prs-se-custom-24-bq,1883,639
1204,640,1279,8,1903,prs-se-silver-sky-moon-white,1895,639
1205,648,1263,8,1903,jackson-usa-signature-mick-thomson-soloist,1895,615
1206,328,633,0,959,esp-ltd-m-1007-qm-stblksbs,959,305
1207,640,1271,16,1911,prs-se-silver-sky-dragon-fruit,1895,631
1208,656,1263,8,1911,charvel-pro-mod-dk-24-2pt-myst-bl,1903,607
1209,640,1271,0,1911,fender-player-telecaster-hh-pf-silver,1911,631
1210,344,629,5,951,harmony-standard-series-juno-pearl-white,946,285
1211,592,1327,16,1903,d-angelico-excel-dc-tour-collection-solid-wine,1887,735
1212,640,1271,16,1903,slick-sl-60-wh,1887,631
1213,320,639,56,903,ibanez-artcore-as93zw-nt,847,319
1214,640,1279,8,1911,squier-classic-vibe-late-50-s-jazzmaster-fsr-gpg-wbl,1903,639
1215,322,647,0,959,ibanez-prestige-rg652ahm-ngb,959,325
1216,632,1287,8,1903,schecter-custom-fr-s-gbs,1895,655
1217,648,1263,16,1903,epiphone-les-paul-modern-figured-caffe-latte-fade,1887,615
1218,576,1338,8,1911,guild-starfire-i-dc-vwn,1903,762
1219,312,647,0,959,esp-ltd-ec-401-bk,959,335
1220,632,1287,16,1903,schecter-tommy-victor-devil-fr,1887,655
1221,648,1263,8,1911,jackson-pro-sl3r-mirror-mirror,1903,615
1222,632,1287,0,1911,ibanez-artist-ar420-tbg,1911,655
1223,610,1314,0,1917,esp-ltd-ec-1000t-ctm-tsbs,1917,704
1224,648,1271,8,1911,charvel-pro-mod-socal-style-2-24-ht-sbk-10152030,1903,623
1225,640,1271,8,1911,fender-player-telecaster-pf-3ts,1903,631
1226,328,623,72,887,esp-usa-eclipse-vn-duncan,815,295
1227,318,637,0,959,schecter-hellraiser-c-8-bch,959,319
1228,360,599,104,847,harmony-standard-series-silhouette-3-tone-sunburst,743,239
1229,664,1255,8,1911,jackson-js-series-dinky-arch-top-js22-7-dka-ht,1903,591
1230,632,1287,8,1911,squier-classic-vibe-70s-jaguar-3ts,1903,655
1231,630,1287,16,1911,gamble-guitars-rockfire-10th-anniversary,1895,657
1232,648,1271,8,1911,sterling-by-music-man-john-petrucci-jp15-7-eminence-purple-bust,1903,623
1233,320,639,5,951,ibanez-ar325qa-dbs,946,319
1234,320,639,8,951,danelectro-59x12-br,943,319
1235,320,639,0,959,yamaha-pacifica-112v-bl-10132193,959,319
1236,304,655,0,959,esp-ltd-f-200-black-satin,959,351
1237,656,1263,0,1919,ibanez-az2407f-bsr,1919,607
1238,592,1319,0,1911,jackson-pro-series-phil-demmel-demmelition-fury-rtf,1911,727
1239,664,1255,0,1919,jackson-pro-sl2q-mah-trans-green,1919,591
1240,312,655,0,943,ibanez-signature-gb10-bs-george-benson,943,343
1241,592,1327,8,1911,gretsch-guitars-g6120t-pro-player-s-edition-nashville-azm,1903,735
1242,640,1279,0,1919,squier-affinity-jazzmaster-bmm,1919,639
1243,592,1327,8,1903,gretsch-guitars-g5420tg-ltd-50-s-or,1895,735
1244,568,1346,0,1914,esp-ltd-deluxe-arrow-1000nt-cms,1914,778
1245,640,1279,16,1903,prs-custom-24-10-top-charcoal-cherry,1887,639
1246,304,655,0,959,esp-ltd-ns-6-blks-nergal-stream-signature-incl-case,959,351
1247,656,1263,8,1911,ibanez-gio-grg121dx-wnf,1903,607
1248,576,1338,8,1911,guild-starfire-i-dc-vwn-b-stock,1903,762
1249,272,671,8,959,godin-5th-ave-night-club-ib,951,399
1250,656,1271,0,1919,esp-e-ii-m-ii-7b-baritone-evertune-pw,1919,615
1251,656,1263,8,1903,schecter-demon-7-crb,1895,607
1252,286,671,0,959,esp-ltd-arrow1000-violet-andromeda,959,385
1253,312,647,8,951,esp-ltd-ec-256-blk,943,335
1254,664,1255,8,1911,jackson-slatx7qm-ms-tr-bl-brst,1903,591
1255,648,1271,16,1903,slick-sl-57-vsb,1887,623
1256,648,1271,0,1911,fender-player-stratocaster-hss-floyd-mn-pwt,1911,623
1257,648,1271,8,1895,friedman-vintage-t-holo-flake,1887,623
1258,616,1303,0,1919,yamaha-revstar-rss20bl-black,1919,687
1259,344,601,96,859,peavey-raptor-plus-sss-red,763,257
1260,656,1271,16,1903,haar-traditional-s-lake-placid-blue-10148699,1887,615
1261,328,634,0,959,charvel-warren-demartini-signature-snake-pro-mod,959,306
1262,648,1271,8,1911,fender-player-stratocaster-mn-cor,1903,623
1263,640,1279,8,1911,squier-bullet-tele-blk,1903,639
1264,600,1311,8,1919,d-angelico-excel-ss-tour-solid-wine,1911,711
1265,328,631,8,959,esp-ltd-m-1007ms-stblks,951,303
1266,648,1271,16,1903,fender-custom-shop-50s-twisted-tele-journeyman-relic,1887,623
1267,656,1279,8,1903,sandberg-forty-eight-ts-sa,1895,623
1268,571,1354,0,1914,esp-ltd-deluxe-arrow-1000-evertune-blk,1914,783
1269,352,615,80,883,esp-usa-m-iii-gt-ash-e-b-red-ch-sd-10140670,803,263
1270,640,1279,8,1911,d-angelico-deluxe-atlantic-le-sage,1903,639
1271,640,1279,8,1903,prs-se-silver-sky-moon-white-10149914,1895,639
1272,656,1263,8,1911,schecter-banshee-mach-6-fob,1903,607
1273,328,631,5,959,paoletti-stratospheric-loft-hss-heavy-sage-green,954,303
1274,648,1271,0,1919,fender-american-performer-strat-rw-hss-aub,1919,623
1275,648,1271,8,1911,fender-player-plus-stratocaster-mn-3-ts,1903,623
1276,632,1287,8,1911,gretsch-guitars-electromatic-g5222-double-jet-ldn-gry,1903,655
1277,616,1303,0,1919,yamaha-revstar-rss20swb-swift-blue,1919,687
1278,328,631,0,959,esp-ltd-sc-607-baritone-ps-stephen-carpenter,959,303
1279,320,639,0,959,schecter-hellraiser-c-1-bch,959,319
1280,248,727,0,959,danelectro-59-m-nos-modified-or,959,479
1281,640,1271,8,1911,squier-classic-vibe-70s-stratocaster-lh-hss-blk,1903,631
1282,656,1263,8,1903,jackson-dinky-minion-js1x-black-am,1895,607
1283,600,1327,8,1911,gretsch-guitars-g6118-et-anniversary-pro-player-s-edition-cpm,1903,727
1284,648,1271,8,1911,fender-american-professional-ii-stratocaster-rw-mbl,1903,623
1285,712,1207,224,1695,guild-surfliner-catalina-blue,1471,495
1286,328,634,0,951,ibanez-rg550-pn-genesis-collection,951,306
1287,384,575,192,767,epiphone-sg-standard-aw,575,191
1288,632,1287,16,1903,nik-huber-orca-59-faded-tobacco-sunburst,1887,655
1289,656,1263,0,1919,charvel-jim-root-pro-mod-style-1-satin-white,1919,607
1290,344,615,56,903,ibanez-prestige-rgr5221-tfr,847,271
1291,290,663,0,951,guild-starfire-iv-st-eg,951,373
1292,320,631,0,959,schecter-omen-8-blk,959,311
1293,640,1279,8,1911,gretsch-guitars-g5655t-cb-jr-jde-gry,1903,639
1294,312,647,0,951,esp-ltd-ec-1000fm-te-fluence,951,335
1295,648,1279,16,1903,gibson-billy-joe-armstrong-lp-junior,1887,631
1296,328,631,0,959,esp-ltd-h-1001-stbc-see-thru-black-cherry,959,303
1297,656,1263,8,1911,schecter-reaper-6-fr-s-inb,1903,607
1298,640,1279,0,1919,yamaha-pacifica-311h-bl,1919,639
1299,600,1319,2,1911,ibanez-ekm100-wrd-eric-krasno-10150523,1909,719
1300,328,631,40,919,esp-ltd-ec-407-bks,879,303
1301,704,1213,239,1686,guild-surfliner-hh-canyon-dusk,1447,509
1302,312,639,8,959,esp-ltd-ec-1000-blknb,951,327
1303,656,1263,8,1911,caparison-horus-m3-ef-te,1903,607
1304,344,615,80,879,slick-sl-51-ba,799,271
1305,656,1263,0,1919,ibanez-gio-grgr221pa-aqb,1919,607
1306,320,639,0,959,esp-ltd-m-403ht-fm-ns,959,319
1307,656,1263,8,1911,charvel-pro-mod-socal-style-1-hsh-fr-m-cherry-kiss-burst,1903,607
1308,301,655,0,959,ibanez-signature-gb10-nt-george-benson,959,354
1309,648,1271,0,1919,ibanez-gsa60qa-tbb,1919,623
1310,648,1271,0,1919,fender-american-professional-ii-stratocaster-mn-mbl,1919,623
1311,352,607,88,871,slick-sl57-db,783,255
1312,584,1327,8,1903,jackson-x-series-kexq-tr-grn,1895,743
1313,312,649,0,959,esp-ltd-as-1fr-blkaqsb-alex-skolnick-signature-black-aqua,959,337
1314,656,1279,8,1903,sandberg-forty-eight-car-sa,1895,623
1315,664,1255,8,1911,ibanez-mm1-tab-martin-miller-signature,1903,591
1316,621,1295,13,1911,esp-ltd-ec-1000s-fluence,1898,674
1317,640,1279,0,1919,fender-jim-adkins-telecaster-crt-10115369,1919,639
1318,328,639,8,951,suhr-pete-thorn-signature-vg,943,311
1319,656,1263,0,1919,charvel-jim-root-pro-mod-style-1-satin-black,1919,607
1320,656,1263,8,1911,charvel-dk-22-sss-2pt-blk,1903,607
1321,616,1303,16,1903,schecter-v-1-fr-s-apocalypse-rr,1887,687
1322,328,639,0,959,esp-signature-kirk-hammett-kh-2-vintage,959,311
1323,600,1319,8,1911,jackson-pro-rhoads-rr24-lightning-crackle,1903,719
1324,664,1255,0,1919,ibanez-prestige-az24027-tff,1919,591
1325,320,639,0,959,g-l-tribute-comanche-eb,959,319
1326,320,631,0,959,ibanez-gio-gsa60-bs,959,311
1327,648,1271,8,1911,fender-american-ultra-luxe-stratocaster-rw-hss-fr-mbk,1903,623
1328,320,615,24,935,gibson-custom-shop-1957-les-paul-junior-tv-10149329,911,295
1329,616,1303,8,1911,d-angelico-exl-mini-dc-trans-cherry-10145592,1903,687
1330,640,1279,8,1911,fender-vintera-60-s-jazzmaster-mod-sfg,1903,639
1331,656,1263,16,1903,fender-custom-shop-tomatillo-relic-strat,1887,607
1332,384,575,176,783,kramer-the-84-blue-metallic,607,191
1333,648,1279,8,1911,slick-sl-57-bk,1903,631
1334,640,1271,8,1911,squier-classic-vibe-60s-esquire-custom-blk,1903,631
1335,648,1271,8,1911,charvel-pro-mod-san-dimas-style-1-hss-fr-platinum-pearl-10144828,1903,623
1336,656,1263,8,1911,jackson-chris-broderick-pro-soloist-ht6p-tbl,1903,607
1337,625,1295,0,1915,esp-ltd-sn-1-ht-blkblast,1915,670
1338,656,1263,8,1911,schecter-nick-johnston-traditional-ao,1903,607
1339,638,1279,8,1911,d-angelico-premier-atlantic-bf,1903,641
1340,344,615,80,877,esp-usa-eclipse-stbc,797,271
1341,656,1263,8,1911,jackson-pro-series-misha-mansoor-juggernaut-et6-cgry,1903,607
1342,648,1263,0,1911,fender-player-stratocaster-hss-mn-bcr,1911,615
1343,648,1271,16,1903,yamaha-sg-1820-bs,1887,623
1344,656,1263,8,1911,schecter-silver-mountain-c-1-bm,1903,607
1345,328,639,8,958,slick-sl-50-m-sg,950,311
1346,328,631,0,951,jackson-pro-series-sl2-mick-thomson-awh,951,303
1347,640,1271,0,1919,fender-american-ultra-stratocaster-rw-apl,1919,631
1348,654,1263,8,1911,caparison-horus-wb-fx-mf-nt-10151126,1903,609
1349,320,639,0,959,esp-ltd-mirage-deluxe-87-turq-turquoise,959,319
1350,648,1271,8,1911,fender-american-professional-ii-telecaster-mn-mbl,1903,623
1351,648,1271,0,1919,ibanez-kikosp3-teb,1919,623
1352,656,1263,0,1919,charvel-pro-mod-dk24-hh-ht-desert-sand,1919,607
1353,640,1279,0,1919,fender-american-ultra-telecaster-mn-cob,1919,639
1354,640,1279,8,1911,fender-vintera-50-s-tele-frd,1903,639
1355,291,663,5,951,guild-starfire-v-snowcrest-white,946,372
1356,648,1271,16,1903,slick-sl-60-bk,1887,623
1357,648,1271,0,1919,gretsch-guitars-guitars-g6129t-89-vintage-select-sparkle-jet-gsp,1919,623
1358,588,1331,0,1919,duesenberg-starplayer-tv-25th-anniversary-silver-metallic,1919,743
1359,616,1303,8,1911,d-angelico-deluxe-ss-le-rus,1903,687
1360,632,1287,0,1919,gretsch-guitars-electromatic-g5210t-p90-petrol,1919,655
1361,648,1271,8,1911,fender-american-performer-tele-hum-mn-3tsb,1903,623
1362,648,1271,8,1911,fender-american-professional-ii-stratocaster-rw-rst-pin,1903,623
1363,648,1263,16,1895,epiphone-les-paul-modern-graphite-black,1879,615
1364,641,1287,0,1915,esp-ltd-mirage-deluxe-87-mg,1915,646
1365,664,1255,8,1911,squier-classic-vibe-60s-mustang-snb,1903,591
1366,602,1311,0,1919,duesenberg-fullerton-tv-black,1919,709
1367,648,1271,0,1919,fender-american-ultra-stratocaster-mn-mbst,1919,623
1368,288,671,0,959,gretsch-guitars-g100cebk-synchromatic-cutaway-black,959,383
1369,320,639,0,959,esp-ltd-m-1-custom-87-blk,959,319
1370,648,1271,8,1911,haar-traditional-s-aged-shell-pink,1903,623
1371,600,1319,8,1911,squier-affinity-starcaster-mn-3ts,1903,719
1372,600,1311,8,1911,jackson-x-series-kvxmg-slm-gr-w-blk,1903,711
1373,629,1295,0,1919,esp-ltd-sn-1000ht-fb,1919,666
1374,664,1255,0,1919,squier-classic-vibe-60s-competition-mustang-cpo,1919,591
1375,648,1271,8,1911,fender-american-professional-ii-stratocaster-hss-rw-mbl,1903,623
1376,640,1271,8,1911,squier-classic-vibe-70s-stratocaster-hss-wal,1903,631
1377,586,1335,8,1911,ibanez-artcore-af55-tkf,1903,749
1378,664,1255,0,1919,ibanez-rg8527-bre,1919,591
1379,632,1287,8,1911,squier-contemporary-jaguar-hh-shoreline-gold,1903,655
1380,376,583,176,783,epiphone-les-paul-special-tv-yellow,607,207
1381,672,1255,8,1903,fender-player-offset-mustang-ssb,1895,583
1382,320,639,0,959,esp-ltd-m-1007-ht-bp-blkfd-black-fade,959,319
1383,656,1263,8,1911,schecter-c-6-fr-pro-cb,1903,607
1384,632,1287,0,1919,evh-wolfgang-standard-quicksilver,1919,655
1385,664,1255,8,1911,schecter-banshee-mach-7-eb,1903,591
1386,584,1335,0,1919,gretsch-guitars-electromatic-g5422tg-dc-scw,1919,751
1387,304,647,0,959,esp-ltd-f-10-kit-blk-black,959,343
1388,656,1263,0,1919,ibanez-rga42hpqm-big,1919,607
1389,640,1279,0,1919,charvel-pro-mod-san-dimas-style-1-old-yella,1919,639
1390,312,650,0,959,esp-ltd-ec-10-kit-black,959,338
1391,640,1271,0,1911,fender-vintera-70-s-tele-custom-sbl,1911,631
1392,328,635,54,903,ibanez-gb10em-aa-george-benson,849,307
1393,656,1271,24,1911,haar-traditional-s-aged-3-tone-sunburst,1887,615
1394,640,1279,8,1911,fender-vintera-60-s-tele-mod-lpb,1903,639
1395,632,1287,0,1911,gretsch-guitars-streamliner-g2655-gnmtl,1911,655
1396,648,1271,16,1903,slick-sl-51-bk-10114790,1887,623
1397,640,1279,24,1895,danelectro-64-dano-mosrite-10084632,1871,639
1398,608,1309,19,1906,eastman-romeo-la-cb,1887,701
1399,320,642,8,951,slick-sl-60-vsb,943,322
1400,664,1255,8,1911,ibanez-mikro-grgm21-bkn,1903,591
1401,592,1327,8,1903,jackson-scott-ian-king-v-kvxt-bk,1895,735
1402,696,1223,209,1711,redwood-relics-60s-s-style-snb,1502,527
1403,640,1279,8,1903,sandberg-california-st-ii-soft-aged-bk,1895,639
1404,640,1287,0,1919,esp-ltd-mirage-deluxe-87-sw,1919,647
1405,344,617,56,903,ibanez-prestige-rg5170g-svf,847,273
1406,616,1303,8,1903,schecter-sls-elite-e-1-evil-twin-sb,1895,687
1407,336,627,8,951,ibanez-rgms8-bk-multiscale,943,291
1408,664,1255,8,1903,ibanez-jbm10fx-pwm-jake-bowen,1895,591
1409,640,1279,0,1919,gretsch-guitars-g6134tfm-nh-nigel-hendroff-sign-penguin,1919,639
1410,648,1271,24,1903,haar-traditional-s-aged-fiesta-red-10118121,1879,623
1411,328,637,0,959,esp-ltd-aw-7-baritone-alex-wade-signature,959,309
1412,656,1263,8,1903,schecter-sls-elite-c-1-fr-s-evil-twin-sbk,1895,607
1413,648,1271,8,1911,schecter-reaper-6-elite-fr-s-deep-ocean-blue,1903,623
1414,648,1271,8,1911,fender-american-professional-ii-telecaster-rw-myst-sfg,1903,623
1415,584,1335,8,1911,hagstrom-super-viking-dandy-dandelion-flame,1903,751
1416,640,1277,8,1911,eastman-sb59-gb-10115671,1903,637
1417,346,607,200,760,godin-5th-avenue-kingpin-p90-cognac-burst,560,261
1418,664,1255,8,1911,jackson-chris-broderick-pro-soloist-6p-tbl,1903,591
1419,317,634,8,959,vintage-icon-v52mrbs,951,317
1420,632,1287,0,1919,gretsch-guitars-streamliner-g2215-p90-jr-jet-hv-brst,1919,655
1421,648,1263,24,1903,slick-sl-59-bk,1879,615
1422,320,615,64,895,esp-usa-eclipse-qm-vn-emg,831,295
1423,672,1247,8,1911,schecter-c-7-pro-aqb,1903,575
1424,616,1303,0,1919,ibanez-amh90-pbm,1919,687
1425,312,655,8,951,gibson-les-paul-standard-60s-bourbon-burst,943,343
1426,320,639,8,951,esp-e-ii-t-b7-baritone-sw,943,319
1427,648,1263,5,1903,duesenberg-double-cat-ctb-12,1898,615
1428,328,639,0,959,schecter-c-1-apocalypse-rg,959,311
1429,648,1279,24,1903,prs-se-silver-sky-stone-blue,1879,631
1430,664,1255,0,1919,ibanez-rgd3121-prf,1919,591
1431,600,1319,8,1911,gretsch-guitars-streamliner-g2420t-gm-10150622,1903,719
1432,288,671,8,953,guild-starfire-i-jet-90-swh,945,383
1433,312,647,8,951,guild-bluesbird-itb,943,335
1434,648,1276,0,1915,esp-ltd-m-1-custom-87-mg,1915,628
1435,656,1271,8,1911,friedman-vintage-t-tangerine-flake-p90,1903,615
1436,664,1263,0,1919,ibanez-azs2209-atq,1919,599
1437,640,1274,8,1911,eastman-sb56-gt,1903,634
1438,648,1271,0,1919,fender-nile-rodgers-hitmaker-stratocaster,1919,623
1439,656,1263,0,1919,ibanez-grg120qasp-bgd,1919,607
1440,322,631,0,951,schecter-c-6-deluxe,951,309
1441,344,615,88,871,suhr-classic-antique-hss-rw-ow-10117072,783,271
1442,736,1183,8,1903,bohemian-oil-can-guitar-bg15ho,1895,447
1443,656,1263,8,1911,schecter-demon-7-absn,1903,607
1444,680,1239,0,1919,ibanez-rg9pb-tgf,1919,559
1445,632,1279,8,1911,fender-player-jaguar-pf-3ts,1903,647
1446,600,1311,8,1903,gretsch-guitars-g6609-tg-broadcaster-pe,1895,711
1447,352,609,87,863,slick-sl57-cr,776,257
1448,622,1300,0,1919,esp-ltd-ec-1001-tef,1919,678
1449,640,1279,0,1919,fender-troy-van-leeuwen-jazzmaster-ca,1919,639
1450,328,623,72,891,esp-usa-eclipse-fm-bh-stbc-emg,819,295
1451,656,1263,8,1911,ibanez-kiko100-tr-kiko-loureiro,1903,607
1452,640,1271,16,1903,epiphone-les-paul-standard-60s-iced-tea,1887,631
1453,584,1335,0,1919,hagstrom-tremar-viking-deluxe-csg-10129735,1919,751
1454,648,1271,0,1919,fender-american-vintage-ii-1957-stratocaster-sfmg,1919,623
1455,328,631,8,951,ibanez-jiva10-dsb-nita-strauss,943,303
1456,648,1279,24,1903,haar-traditional-t,1879,631
1457,664,1247,8,1911,jackson-pro-mdk-7-ms-eureka-mist-10143688,1903,583
1458,656,1255,0,1919,schecter-hellraiser-c-8-fr-bch,1919,599
1459,632,1287,24,1903,prs-private-stock-modern-eagle-v-10151236,1879,655
1460,328,631,2,951,ibanez-tqm1-nt-tom-quayle,949,303
1461,640,1279,8,1911,squier-paranormal-cabronita-telecaster-thinline-gpg-2ts,1903,639
1462,656,1263,16,1903,haar-traditional-s-10128835,1887,607
1463,624,1287,0,1911,gretsch-guitars-g5220-electronatic-jet-bt-csg,1911,663
1464,592,1319,0,1919,gretsch-guitars-electromatic-g5420t-org,1919,727
1465,624,1295,0,1919,evh-wolfgang-standard-gold-sparkle,1919,671
1466,648,1271,0,1919,squier-40th-anniversary-stratocaster-gold-edition-lpb,1919,623
1467,608,1311,0,1919,ibanez-quest-qx527pb-abs,1919,703
1468,640,1279,0,1919,yamaha-pacifica-612-vii-fm-teal-green-metallic,1919,639
1469,632,1271,8,1903,duesenberg-falken-black,1895,639
1470,336,623,0,959,stagg-silveray-custom-deluxe-fred,959,287
1471,648,1271,0,1919,squier-40th-anniversary-vintage-edition-stratocaster-sw2t,1919,623
1472,648,1271,8,1911,fender-american-professional-ii-telecaster-rw-merc,1903,623
1473,664,1255,8,1903,ibanez-pia3761-xb-steve-vai-signature,1895,591
1474,584,1335,16,1903,d-angelico-deluxe-59-sbb,1887,751
1475,648,1271,8,1911,fender-signature-yngwie-malmsteen-vwh-rw,1903,623
1476,664,1249,16,1903,schecter-sls-elite-c-7-fr-black-fade-burst-lefthand,1887,585
1477,648,1271,8,1903,squier-classic-vibe-70s-tele-thinline-nat,1895,623
1478,608,1303,8,1911,jackson-pro-wr7-walnut-mah,1903,695
1479,632,1287,8,1911,gretsch-guitars-g6228tg-jet-players-edition-md-sp,1903,655
1480,320,639,5,951,vintage-reissued-v100-pbb,946,319
1481,352,607,88,871,slick-sl-50-ba-10151234,783,255
1482,640,1271,8,1911,fender-player-jazzmaster-pf-3ts,1903,631
1483,328,623,0,959,schecter-hellraiser-c-9-bch,959,295
1484,640,1287,16,1903,haar-traditional-jm-2tone-sunburst,1887,647
1485,320,639,0,959,esp-ltd-h3-1000-fm-black-turqoise-burst,959,319
1486,632,1287,0,1919,evh-wolfgang-standard-qm-chlorine-burst,1919,655
1487,592,1327,0,1919,ibanez-artcore-af75g-bkf,1919,735
1488,648,1263,0,1919,ibanez-js140m-sdl,1919,615
1489,592,1327,8,1911,d-angelico-excel-dc-tour-collection-solid-black,1903,735
1490,656,1263,16,1903,ibanez-signature-js2450-mcp-joe-satriani,1887,607
1491,608,1314,0,1919,danelectro-59x-blk-10114286,1919,706
1492,640,1279,8,1911,hagstrom-ultra-max-special-beryl-flame,1903,639
1493,648,1271,0,1919,charvel-pro-mod-san-dimas-style-1-black,1919,623
1494,336,623,32,919,charvel-pro-mod-socal-2h-fr-sw,887,287
1495,293,663,8,951,guild-x-175-manhattan-bld,943,370
1496,648,1271,8,1911,hagstrom-ultra-max-fall-sky-satin,1903,623
1497,640,1279,8,1911,fender-player-plus-nashville-telecaster-acar,1903,639
1498,304,659,0,959,ibanez-artcore-as93fm-tcd,959,355
1499,672,1247,8,1911,gretsch-guitars-g5260-emtc-jet-bari-ldn-gry,1903,575
1500,656,1319,16,1903,danelectro-59xt-svr-aqua,1887,663
1501,648,1271,0,1919,squier-affinity-strat-hh-owh,1919,623
1502,656,1263,8,1911,ibanez-micro-grgm21m-ca,1903,607
1503,624,1298,0,1917,esp-ltd-sn-200ht-chms,1917,674
1504,656,1263,8,1911,schecter-silver-mountain-c-7-multiscale-bm,1903,607
1505,616,1303,8,1911,d-angelico-premier-mini-dc-ot,1903,687
1506,648,1271,16,1911,sandberg-sandberg-electra-ii-dc-bk-mn,1895,623
1507,656,1263,8,1911,schecter-c-6-pro-fr-aqb,1903,607
1508,600,1319,0,1919,gretsch-guitars-electromatic-g5422g-12-sbb,1919,719
1509,642,1279,3,1914,esp-ltd-deluxe-m-1000-snow-white,1911,637
1510,320,642,8,951,guild-s-200-t-bird-atb,943,322
1511,288,671,8,951,guild-starfire-i-sc-atb,943,383
1512,648,1263,16,1903,schecter-hellraiser-hybrid-pt-7-tbb,1887,615
1513,640,1279,0,1919,gretsch-guitars-electromatic-g5222-double-jet-vintage-white,1919,639
1514,640,1279,16,1903,haar-traditional-t-aged-vintage-white-10126975,1887,639
1515,624,1295,8,1911,gretsch-guitars-electromatic-g5222-double-jet-wlnt,1903,671
1516,320,631,0,959,slick-sl54-m-sg,959,311
1517,648,1271,0,1911,fender-player-stratocaster-hss-mn-silver,1911,623
1518,656,1271,16,1903,slick-sl-50-sg,1887,615
1519,616,1303,0,1919,jackson-x-series-warrior-wrx24-sbk,1919,687
1520,664,1255,8,1911,schecter-keith-merrow-km-7-mk-iii-artist-blue-crimson,1903,591
1521,648,1263,8,1903,epiphone-les-paul-muse-radio-blue-metallic,1895,615
1522,656,1263,8,1911,schecter-reaper-7-multiscale-scb,1903,607
1523,656,1255,8,1903,jackson-usa-signature-adrian-smith-sig-sd-tr-grn,1895,599
1524,317,631,0,959,gibson-les-paul-standard-60s-unburst,959,314
1525,648,1271,8,1911,fender-vintera-50-s-strat-mod-2tsb,1903,623
1526,312,650,8,951,esp-ltd-ec-256-vn-vintage-natural,943,338
1527,656,1263,0,1919,ibanez-azes31-prb,1919,607
1528,632,1287,8,1903,gretsch-guitars-g5230t-jet-ft-blk,1895,655
1529,624,1295,8,1905,d-angelico-premier-bedford-bf,1897,671
1530,656,1263,8,1911,caparison-dellinger-ii-fx-prominence-ef-tsbl,1903,607
1531,640,1279,8,1911,fender-noventa-jazzmaster-mn-frd,1903,639
1532,664,1255,16,1895,epiphone-1961-les-paul-sg-standard-aged-classic-white,1879,591
1533,632,1279,3,1903,duesenberg-double-cat-ddc-bk,1900,647
1534,312,645,0,959,esp-ltd-phoenix-1000-stbc,959,333
1535,309,654,0,959,esp-ltd-ec1000-piezo-qm-stb-see-thru-blue,959,345
1536,320,641,56,903,ibanez-artcore-as73fm-tif,847,321
1537,648,1269,8,1911,eastman-sb55dc-v,1903,621
1538,328,623,0,959,charvel-pro-mod-dk24-hss-2pt-cm-10106964,959,295
1539,320,634,8,951,esp-e-ii-horizon-nt-7-et-blk,943,314
1540,640,1271,8,1911,fender-player-telecaster-mn-3ts-10144965,1903,631
1541,640,1279,16,1903,gibson-custom-shop-1957-les-paul-junior-vs-10149313,1887,639
1542,288,671,0,959,godin-5th-ave-uptown-custom-havana-brown,959,383
1543,648,1271,0,1919,fender-american-professional-ii-stratocaster-mn-myst-sfg,1919,623
1544,656,1263,8,1919,schecter-hellraiser-hybrid-pt-7-uv,1911,607
1545,648,1263,8,1911,ibanez-gio-grx40-bkn,1903,615
1546,664,1255,8,1911,charvel-pro-mod-dk-24-2pt-snow-whit,1903,591
1547,648,1271,16,1903,fender-troy-van-leeuwen-jazzmaster,1887,623
1548,344,615,72,887,slick-sl-59-bwn,815,271
1549,640,1279,0,1919,fender-gold-foil-jazzmaster-eb-cab,1919,639
1550,312,647,0,959,paoletti-nancy-loft-ss-1-10-sage-green,959,335
1551,664,1255,16,1911,charvel-pro-mod-dk24-hh-2pt-cm-mblfrst,1895,591
1552,624,1298,0,1917,esp-ltd-ec-201-black-satin,1917,674
1553,328,629,8,959,esp-ltd-mh-17-kit-blk,951,301
1554,656,1263,8,1911,jackson-mj-series-dinky-dkr-gloss-black,1903,607
1555,600,1319,16,1903,d-angelico-premier-dc-fr,1887,719
1556,640,1271,8,1903,gretsch-guitars-g6129t-red-sparkle-pe,1895,631
1557,344,623,56,903,ibanez-sa460qmw-tqb,847,279
1558,296,663,0,959,vintage-icon-v6mrlbr-100047800,959,367
1559,632,1279,8,1911,fender-player-jaguar-pf-blk,1903,647
1560,620,1303,0,1914,esp-ltd-deluxe-ec-1000t-ctm-violet-shadow,1914,683
1561,656,1263,0,1919,fender-signature-strat-robert-cray,1919,607
1562,392,567,216,743,fender-player-stratocaster-hss-mn-tpl,527,175
1563,672,1247,8,1911,schecter-hellraiser-hybrid-c-8-tbb,1903,575
1564,648,1271,8,1911,squier-contemporary-stratocaster-special-sbrst-met,1903,623
1565,648,1279,24,1895,haar-traditional-t-aged-orange-seethrough,1871,631
1566,616,1287,8,1911,danelectro-59x-aqu,1903,671
1567,312,639,0,951,gretsch-guitars-g6128t-57-vintage-select-duo-jet-cg,951,327
1568,640,1271,8,1911,fender-jimmy-page-tele-rw-nat,1903,631
1569,640,1279,0,1919,fender-american-pro-ii-jazzmaster-rw-dk-nit,1919,639
1570,304,631,0,959,harmony-standard-series-rebel-pearl-white,959,327
1571,664,1255,0,1919,ibanez-iron-label-ictb721-bkf,1919,591
1572,648,1271,8,1911,fender-custom-shop-fat-50s-stratocaster-relic,1903,623
1573,640,1279,8,1911,hagstrom-ultra-max-special-antique-flame,1903,639
1574,632,1279,8,1903,gretsch-guitars-g5655tg-center-block-jr-org,1895,647
1575,304,647,0,959,danelectro-blackout-59-purple-metal-flak,959,343
1576,592,1319,8,1911,gretsch-guitars-streamliner-g2410tg-village-amber,1903,727
1577,344,622,56,903,ibanez-sa460mbw-sub,847,278
1578,656,1255,0,1919,gretsch-guitars-g5260t-emtc-jet-bari-mdsph,1919,599
1579,656,1263,232,1703,guild-x-175-manhattan-special-canyon-dusk,1471,607
1580,296,663,8,959,gretsch-guitars-l-g6120t-55-chet-atkins,951,367
1581,312,631,0,959,gibson-60th-anniversary-1961-sg-les-paul-standard-reissue,959,319
1582,648,1279,16,1895,haar-traditional-t-deluxe,1879,631
1583,600,1327,8,1911,squier-contemporary-active-starcaster-sfp,1903,727
1584,648,1271,0,1919,fender-brad-paisley-road-worn-esquire,1919,623
1585,314,639,0,951,esp-ltd-h-200-fm-stp,951,325
1586,312,647,8,959,gretsch-guitars-g6228fm-players-edition-jet-bt-dcs,951,335
1587,644,1282,0,1919,esp-ltd-deluxe-h-1000-evertune-see-thru-purple-sunburst,1919,638
1588,320,639,0,959,esp-ltd-m-400-blks,959,319
1589,633,1295,0,1914,esp-ltd-te-200-tsb,1914,662
1590,312,647,8,951,esp-ltd-ec-1000t-fm-hbs-f-honey-burst-satin,943,335
1591,648,1271,0,1919,fender-tom-morello-soul-power-stratocaster,1919,623
1592,320,642,24,951,esp-ltd-viper-10-kit-bk,927,322
1593,376,583,176,783,kramer-baretta-feral-cat,607,207
1594,648,1271,16,1903,maybach-albatroz-65-aged-dark-winered,1887,623
1595,336,655,8,953,redwood-relics-60s-s-style-hss-owt-over-3ts,945,319
1596,328,631,0,951,jackson-pro-series-misha-mansoor-juggernaut-ht6-stn-blk,951,303
1597,656,1271,16,1903,haar-traditional-s-teal-green-metallic,1887,615
1598,320,639,0,959,esp-e-ii-horizon-fr-7-blk,959,319
1599,649,1287,8,1895,epiphone-les-paul-custom-aw-10119988,1887,638
1600,312,647,0,959,esp-ltd-deluxe-ec-1000-qm-stbc,959,335
1601,320,639,0,959,esp-e-ii-horizon-nt-ii-stblksb,959,319
1602,640,1279,16,1903,duesenberg-paloma-red-sparkle,1887,639
1603,600,1319,8,1911,d-angelico-deluxe-dc-stw,1903,719
1604,640,1279,0,1919,fender-american-pro-ii-jazzmaster-rw-3tsb,1919,639
1605,347,615,72,893,esp-usa-horizon-ii-sbm-emg,821,268
1606,648,1287,8,1903,squier-classic-vibe-60s-jazzmaster-owt,1895,639
1607,656,1255,8,1911,gretsch-guitars-g5260-emtc-jet-bari-dcm,1903,599
1608,320,615,64,895,esp-usa-viper-bh-blk-emg-10140674,831,295
1609,648,1263,0,1911,fender-player-stratocaster-pls-top-pf-tbs,1911,615
1610,624,1263,0,1903,duesenberg-starplayer-tv-ss-10122724,1903,639
1611,632,1287,8,1911,sterling-by-music-man-cutlass-sss-vs,1903,655
1612,648,1271,8,1911,schecter-c-6-plus-electric-magenta,1903,623
1613,712,1207,216,1695,guild-surfliner-white-sage,1479,495
1614,648,1271,8,1911,fender-eric-clapton-stratocaster-trd,1903,623
1615,584,1334,8,1911,gretsch-guitars-g6120t-hr-brian-setzer-hot-rod-mspkl,1903,750
1616,648,1271,0,1919,fender-american-ultra-stratocaster-mn-cob,1919,623
1617,328,639,8,951,g-l-fullerton-deluxe-legacy-ost,943,311
1618,344,611,103,859,vintage-reissued-v100-pgm,756,267
1619,312,650,0,959,esp-ltd-deluxe-ec-1000-vintage-black-emg,959,338
1620,648,1279,16,1903,haar-traditional-t-aged-sonic-blue-hh,1887,631
1621,664,1255,0,1919,ibanez-az2204nw-mgr,1919,591
1622,664,1255,8,1911,schecter-banshee-mach-7-fob,1903,591
1623,640,1279,0,1919,fender-american-ultra-jazzmaster-mn-cob,1919,639
1624,592,1319,8,1903,gretsch-guitars-streamliner-g2622-wlnt,1895,727
1625,648,1271,8,1911,schecter-sc87-machine-gun-kelly-sign-pt-sbk,1903,623
1626,352,615,88,871,slick-sl-60-sg,783,263
1627,640,1279,8,1911,fender-american-ultra-luxe-telecaster-mn-hh-fr-mbk,1903,639
1628,656,1263,0,1919,jackson-x-series-soloist-slx-dx-granite-crystal,1919,607
1629,648,1263,8,1911,sterling-by-music-man-john-petrucci-majesty-x-fmmp,1903,615
1630,288,671,8,951,esp-ltd-arrow-200-blk,943,383
1631,616,1303,0,1919,yamaha-revstar-rsp02tcrg-crisp-gold,1919,687
1632,640,1271,8,1903,jackson-dinky-js11-gbk-10116533,1895,631
1633,584,1335,8,1911,gretsch-guitars-g6122tg-players-edition-country-gentleman-wlnt,1903,751
1634,640,1279,8,1911,fender-player-plus-telecaster-pf-svs,1903,639
1635,288,671,0,959,heritage-artisan-aged-collection-h-535,959,383
1636,640,1279,0,1919,yamaha-pacifica-311h-rm,1919,639
1637,632,1231,16,1895,jackson-js-42-dinky-dkm-nat,1879,599
1638,320,639,0,959,slick-sl-50-m-vc,959,319
1639,648,1271,0,1919,fender-american-professional-ii-stratocaster-mn-3ts,1919,623
1640,656,1263,8,1911,jackson-pro-mdk-evtn7-pgry,1903,607
1641,352,615,88,872,slick-sl-57-m-vc,784,263
1642,368,599,8,951,hoefner-shorty-black,943,231
1643,608,1311,8,1911,jackson-mj-series-rrt-rhoads-black,1903,703
1644,648,1271,8,1911,gretsch-guitars-electromatic-g5655t-cb-center-block-jr-blkgld,1903,623
1645,632,1271,16,1903,duesenberg-falken-black-s,1887,639
1646,352,607,88,871,slick-sl-54t-bk,783,255
1647,592,1327,8,1911,gretsch-guitars-streamliner-g2622t-p90-forge-glow,1903,735
1648,640,1279,8,1911,sterling-by-music-man-cutlass-ct30sss-charcoal-frost,1903,639
1649,624,1295,8,1911,jackson-rhoads-rr24x-mg7-satin-black-primer-grey-bevels,1903,671
1650,632,1287,0,1919,gretsch-guitars-g5220-electromatic-jet-bt-mdsph,1919,655
1651,656,1255,8,1919,schecter-sls-elite-c-1-fr-s-antique-fade-burst,1911,599
1652,664,1255,16,1911,ibanez-azs2200-rbs-prestige,1895,591
1653,328,623,24,935,epiphone-slash-les-paul-standard-nb,911,295
1654,648,1263,8,1903,schecter-van-nuys-pt-gna,1895,615
1655,648,1271,8,1911,jackson-dinky-dk2xrht-gloss-black-10127534,1903,623
1656,648,1271,0,1919,fender-american-professional-ii-stratocaster-mn-owh,1919,623
1657,592,1327,0,1919,jackson-pro-kv6-cory-beaulieu-king-v-winterstorm,1919,735
1658,656,1271,24,1903,sandberg-sandberg-electra-ii-dc-bk-pf,1879,615
1659,656,1255,0,1919,schecter-damien-platinum-8,1919,599
1660,648,1271,8,1911,fender-american-professional-ii-tele-dlx-mn-owt,1903,623
1661,664,1255,16,1903,schecter-reaper-7-multiscale-sb,1887,591
1662,672,1247,24,1910,fender-player-offset-mustang-90-agn,1886,575
1663,640,1271,0,1919,fender-american-ultra-telecaster-mn-ultrbst,1919,631
1664,672,1247,8,1911,schecter-c-7-pro-aub,1903,575
1665,656,1271,16,1903,schecter-reaper-6-cb,1887,615
1666,664,1250,16,1887,schecter-hellraiser-c-7-fr-blk,1871,586
1667,664,1239,8,1903,danelectro-66-bt-tr-baritone,1895,575
1668,664,1255,16,1903,schecter-banshee-mach-7-fr-s-eb,1887,591
1669,648,1271,8,1911,fender-player-telecaster-mn-cor,1903,623
1670,592,1327,8,1911,gretsch-guitars-g6636t-pro-richard-fortus-signature-falcon-vwht,1903,735
1671,352,607,80,871,slick-sl-54-vc,791,255
1672,352,607,88,879,slick-sl-50-cr,791,255
1673,608,1298,16,1895,prs-se-hollowbody-ii-piezo-peacock-blue-burst,1879,690
1674,664,1255,8,1911,schecter-hellraiser-hybrid-c-1-fr-tbb,1903,591
1675,632,1279,0,1911,evh-wolfgang-standard-gloss-black,1911,647
1676,608,1319,8,1903,eastman-thinline-t386-rd-classic,1895,711
1677,648,1271,8,1911,schecter-damien-6-sbk,1903,623
1678,608,1311,1,1911,jackson-warrior-js32-sbk-10147933,1910,703
1679,636,1287,0,1911,esp-ltd-viper-1000-baritone-blks-black-satin,1911,651
1680,320,639,8,951,duesenberg-starplayer-tv-phonic-vnw,943,319
1681,546,1386,0,1909,esp-custom-shop-snakebyte-camo,1909,840
1682,672,1239,0,1911,jackson-dinky-dkaf7-ms-gbk,1911,567
1683,600,1319,0,1911,ibanez-artcore-as73-tcd,1911,719
1684,160,319,0,479,schecter-omen-7-blk-10063263,479,159
1685,616,1303,0,1911,jackson-rhoads-rrx24-red-with-black-bevels,1911,687
1686,648,1271,8,1911,fender-american-professional-ii-stratocaster-rw-owh-10152250,1903,623
1687,648,1271,0,1919,fender-american-ultra-stratocaster-mn-ultrbst,1919,623
1688,320,631,0,959,gibson-les-paul-custom-eb-gh-10135209,959,311
1689,592,1327,8,1911,gretsch-guitars-g5410t-rat-matphnt,1903,735
1690,592,1327,0,1911,jackson-king-v-js32t-gbk,1911,735
1691,592,1327,0,1911,gretsch-guitars-streamliner-g2420-va,1911,735
1692,600,1319,0,1919,ibanez-quest-qx52-bkf,1919,719
1693,664,1263,8,1911,jackson-x-series-sl4xdx-specific-ocean,1903,599
1694,634,1279,8,1903,d-angelico-premier-atlantic-oxb,1895,645
1695,616,1295,8,1911,d-angelico-deluxe-mini-dc-sap,1903,679
1696,376,575,176,783,epiphone-sg-standard-cherry,607,199
1697,648,1271,16,1903,fender-custom-shop-hs-telecaster-custom-relic,1887,623
1698,600,1319,0,1919,ibanez-quest-q54-sfm,1919,719
1699,648,1271,8,1911,fender-player-plus-stratocaster-hss-pf-svb,1903,623
1700,616,1303,0,1919,ibanez-gb10sefm-srr-george-benson,1919,687
1701,600,1319,0,1919,gretsch-guitars-streamliner-g2622t-strlgrn,1919,719
1702,656,1263,8,1917,evh-5150-standard-natural,1909,607
1703,656,1263,16,1903,schecter-reaper-6-fr-s-sb,1887,607
1704,648,1271,8,1911,fender-signature-strat-buddy-guy-pd,1903,623
1705,632,1287,8,1911,gretsch-guitars-electromatic-g5222-double-jet-nat,1903,655
1706,656,1263,8,1911,fender-cory-wong-stratocsaster-sbt,1903,607
1707,648,1271,24,1895,eastman-sb59-sb,1871,623
1708,288,671,8,951,esp-ltd-arrow-200-blk-10150915,943,383
1709,656,1263,16,1903,kramer-pacer-emerald-green-metal-flake-10149799,1887,607
1710,640,1271,0,1911,fender-player-stratocaster-hss-mn-3ts,1911,631
1711,600,1319,8,1911,gretsch-guitars-streamliner-g2420t-gm,1903,719
1712,648,1271,8,1911,fender-american-professional-ii-telecaster-rw-dk-nit,1903,623
1713,656,1263,8,1911,ibanez-rg421-pfm,1903,607
1714,616,1303,0,1919,yamaha-revstar-rss02tssb,1919,687
1715,648,1271,0,1919,squier-40th-anniversary-vintage-edition-telecaster-svb,1919,623
1716,304,647,0,959,jackson-rhoads-rr-pro-snwh,959,343
1717,328,623,24,935,jackson-x-series-adrian-smith-sdx-snwh-bp,911,295
1718,664,1255,8,1911,schecter-keith-merrow-km-7-mk-iii-hybrid-telesto-grey,1903,591
1719,672,1247,8,1911,fender-kurt-cobain-jagstang-snb,1903,575
1720,616,1303,8,1911,d-angelico-deluxe-mini-dc-stw-10148692,1903,687
1721,656,1255,0,1911,jackson-dinky-js32-dka-neon-orange,1911,599
1722,656,1263,8,1911,ibanez-prestige-rg652ahmfx-ngb,1903,607
1723,648,1271,8,1911,fender-vintera-60-s-strat-olw,1903,623
1724,320,638,0,959,g-l-fullerton-deluxe-s-500-3ts,959,318
1725,632,1279,0,1911,jackson-js-22q-sc-monarkh-tpb,1911,647
1726,328,639,8,959,ibanez-gio-grg140-wh,951,311
1727,650,1274,5,1914,esp-ltd-deluxe-h3-1000fr-snow-white,1909,624
1728,664,1255,0,1919,ibanez-az2204nw-dtb,1919,591
1729,648,1271,8,1911,charvel-pro-mod-socal-style-2-24-ht-sbk,1903,623
1730,328,634,8,951,esp-ltd-h-1001-fr-bp-blknb,943,306
1731,344,616,56,903,ibanez-prestige-az2204b-bk,847,272
1732,640,1279,8,1911,gretsch-guitars-streamliner-g2655t-p90-brownstone,1903,639
1733,616,1303,0,1919,yamaha-revstar-rsp20swb-swift-blue,1919,687
1734,328,623,32,919,fender-brad-paisley-road-worn-telecaster,887,295
1735,664,1255,8,1911,schecter-keith-merrow-km-6-mk-iii-hybrid-telesto-grey,1903,591
1736,632,1279,0,1911,gretsch-guitars-streamliner-g2655-sngbrl,1911,647
1737,304,659,0,959,ibanez-artcore-as93fm-vls,959,355
1738,648,1287,16,1903,gibson-custom-shop-61-sg-standard-reissue-m2m,1887,639
1739,600,1311,16,1895,gibson-custom-shop-1961-es-335-vos-vintage-burst-10149331,1879,711
1740,584,1343,8,1911,gretsch-guitars-g6136t-pro-players-edition-falcon-wht,1903,759
1741,608,1311,0,1919,ibanez-artcore-as53-srf,1919,703
1742,648,1271,0,1919,fender-vintera-70-s-strat-fmg-limited-edition,1919,623
1743,648,1271,8,1911,fender-american-professional-ii-telecaster-mn-3tsb,1903,623
1744,656,1263,0,1919,ibanez-prestige-rg5320c-dfm,1919,607
1745,600,1311,16,1895,gibson-custom-shop-1961-es-335-vos-vintage-burst-10151919,1879,711
1746,288,671,8,959,guild-t-50-slim-vs,951,383
1747,320,647,0,951,vintage-icon-v120mrbk,951,327
1748,640,1279,8,1911,gretsch-guitars-streamliner-g2655t-p90-craret-burst,1903,639
1749,632,1287,24,1911,prs-mccarty-594-10-top,1887,655
1750,648,1263,8,1903,squier-bullet-strat-rw-bk-10103472,1895,615
1751,616,1303,0,1919,ibanez-iron-label-xptb620-bkf,1919,687
1752,656,1263,8,1911,jackson-js-series-dinky-arch-top-js22-dka-no,1903,607
1753,640,1279,8,1911,duesenberg-starplayer-tv-csr,1903,639
1754,656,1263,0,1919,ibanez-az2203n-bk,1919,607
1755,648,1271,8,1911,schecter-omen-elite-6-bcb,1903,623
1756,664,1255,0,1913,schecter-keith-merrow-km-7-mk-iii-hybrid,1913,591
1757,648,1263,8,1911,fender-player-stratocaster-mn-3-ts,1903,615
1758,320,631,0,951,guild-s-100-polara-bk,951,311
1759,640,1271,0,1919,fender-american-ultra-stratocaster-mn-txt-10126414,1919,631
1760,664,1255,8,1903,ibanez-azs2209h-pbm-prestige,1895,591
1761,640,1279,0,1919,charvel-henrik-danhage-signature-pro-mod-so-cal-style-1-10142590,1919,639
1762,656,1271,8,1911,friedman-vintage-t-mn-hs-surf-green,1903,615
1763,648,1263,8,1903,fender-telecaster-custom-telecaster-fmt-bcb,1895,615
1764,616,1303,8,1911,d-angelico-deluxe-ss-le-sap,1903,687
1765,363,615,0,959,hoefner-shorty-deluxe-red,959,252
1766,312,647,0,959,esp-ltd-ec-258-blks,959,335
1767,312,642,8,959,esp-ltd-ec-1000t-fm-blknb,951,330
1768,592,1327,8,1903,ibanez-artcore-af75-bs,1895,735
1769,632,1279,0,1911,fender-player-jazzmaster-pf-capri-orange,1911,647
1770,656,1263,24,1903,music-man-usa-john-petrucci-jp15-7-bfr-ft-bkb,1879,607
1771,312,647,0,959,danelectro-59-m-nos-modified-10082585,959,335
1772,656,1263,0,1919,ibanez-prestige-rg652ahmfx-rpb-10150605,1919,607
1773,570,1347,0,1914,esp-ltd-arrow-200-military-green-satin,1914,777
1774,616,1303,0,1919,yamaha-revstar-rsp20mlb-moonlight-blue,1919,687
1775,328,647,3,959,schecter-solo-ii-custom-abs,956,319
1776,648,1271,16,1903,fender-limited-edition-1951-telecaster-super-heavy-relic,1887,623
1777,80,879,80,879,esp-ltd-ps-1000-psp-purple-sparkle,799,799
1778,640,1279,16,1903,haar-traditional-t-aged-sonic-faded-blue,1887,639
1779,328,631,0,951,ibanez-prestige-az2204-icm-10135171,951,303
1780,632,1287,8,1911,evh-wolfgang-standard-cream-white,1903,655
1781,624,1295,16,1911,ibanez-artcore-am93me-nt,1895,671
1782,320,639,0,959,maybach-lester-midnight-sunset-59-aged,959,319
1783,648,1271,0,1919,fender-american-performer-tele-hum-mn-vwt,1919,623
1784,640,1295,0,1919,danelectro-59-m-nos-modified,1919,655
1785,656,1263,8,1911,fender-american-performer-strat-mn-slpb,1903,607
1786,664,1255,0,1919,ibanez-rg7320ex-bkf,1919,591
1787,312,649,0,959,danelectro-59-12-string-10071220,959,337
1788,656,1263,0,1911,ibanez-rg421pb-sbf,1911,607
1789,664,1255,0,1919,ibanez-signature-lb1-vl-lari-basilio,1919,591
1790,648,1271,0,1919,ibanez-gio-grx40-ca,1919,623
1791,640,1279,0,1919,fender-american-ultra-telecaster-rw-apl,1919,639
1792,320,639,0,959,g-l-fullerton-deluxe-asat-classic-bluesboy-chy,959,319
1793,656,1263,8,1911,schecter-nick-johnston-traditional-ao-10151626,1903,607
1794,664,1255,8,1911,ibanez-rg320exz-bkf,1903,591
1795,296,663,8,951,hagstrom-viking-taylor-york,943,367
1796,608,1311,0,1919,ibanez-artcore-express-as73g-pbm,1919,703
1797,296,663,8,951,guild-starfire-iv-st-12-ch,943,367
1798,328,639,0,959,schecter-omen-extreme-6-fr-bch-100054246,959,311
1799,664,1255,0,1919,squier-bullet-mustang-hh-impb-10104208,1919,591
1800,640,1287,16,1903,prs-custom-24-wood-library-10132905,1887,647
1801,664,1255,0,1918,schecter-c-8-deluxe,1918,591
1802,648,1271,0,1919,fender-eric-clapton-stratocaster-blk,1919,623
1803,632,1287,8,1911,sterling-by-music-man-cutlass-hss-rg,1903,655
1804,608,1311,8,1911,schecter-sls-elite-v-1-evil-twin-satin-black,1903,703
1805,640,1287,8,1911,gretsch-guitars-electromatic-g5210t-p90-mako-10152280,1903,647
1806,616,1303,16,1903,epiphone-sheraton-ii-pro-eb,1887,687
1807,680,1247,8,1911,jackson-pro-dk-modern-ash-fr7-bk-grn,1903,567
1808,328,631,32,927,esp-ltd-eclipse-87-nt-rbcrk,895,303
1809,336,631,8,951,ibanez-rgms7-bk-multiscale,943,295
1810,648,1279,16,1903,haar-traditional-t-butterscotch-blonde-mn-10141031,1887,631
1811,656,1263,16,1911,haar-traditional-s-black-10140996,1895,607
1812,664,1247,8,1895,danelectro-66-bt-3ts-baritone,1887,583
1813,648,1263,8,1911,fender-custom-shop-1969-relic-strat-black-paisley,1903,615
1814,656,1263,8,1911,sterling-by-music-man-albert-lee-signature-daphne-blue,1903,607
1815,608,1311,0,1919,ibanez-q547-bmm,1919,703
1816,610,1303,8,1909,esp-ltd-iron-cross-snow-white-james-hetfield-10116428,1901,693
1817,643,1282,0,1914,esp-ltd-m-1001nt-charcoal-burst,1914,639
1818,344,615,80,879,slick-sl-57-vc,799,271
1819,648,1279,8,1911,fender-player-plus-stratocaster-mn-tqs,1903,631
1820,624,1287,16,1903,peavey-hp2-tremolo-tiger-eye,1887,663
1821,152,327,8,479,danelectro-59-m-nos-modified-10075389,471,175
1822,328,636,8,959,ibanez-gio-grg131dx-bkf,951,308
1823,328,627,56,891,esp-usa-eclipse-sc-vp-sd,835,299
1824,664,1255,0,1919,ibanez-rga42hptqm-big,1919,591
1825,600,1319,0,1919,ibanez-quest-q52-lbm,1919,719
1826,648,1263,8,1911,evh-striped-series-rbw,1903,615
1827,640,1279,8,1911,d-angelico-deluxe-brighton-le-sage,1903,639
1828,664,1255,8,1911,ibanez-apex30-mgm-munky-korn,1903,591
1829,648,1271,0,1911,fender-custom-tele-fmt,1911,623
1830,309,655,0,959,esp-ltd-ec-256fm-cb-cobalt-blue,959,346
1831,640,1279,0,1919,gretsch-guitars-streamliner-g2655t-cb-jr-brwnstne,1919,639
1832,688,1230,32,1887,ibanez-signature-m80m-wk-meshuggah,1855,542
1833,648,1263,8,1903,squier-bullet-fat-strat-rw-blk-10104102,1895,615
1834,336,655,0,959,maybach-lester-cherry-lane-58-aged-10149908,959,319
1835,648,1263,8,1911,schecter-sun-valley-super-shredder-pt-fr-sfmg,1903,615
1836,600,1311,0,1919,danelectro-59-divine-fm,1919,711
1837,656,1271,0,1919,schecter-sls-elite-pt-black-fade-burst,1919,615
1838,640,1279,0,1919,evh-wolfgang-standard-exotic-poplar-burl,1919,639
1839,592,1327,16,1895,d-angelico-deluxe-59-stw,1879,735
1840,648,1271,8,1911,hagstrom-ultra-max-special-deep-space-blue-metallic,1903,623
1841,648,1263,8,1903,squier-bullet-fat-strat-awt,1895,615
1842,304,659,2,959,ibanez-artcore-as73-olm,957,355
1843,664,1263,0,1911,schecter-sls-elite-c-1-fr-s-black-fade-burst-lefthand,1911,599
1844,656,1263,8,1911,charvel-dk-24-hh-2pt-nat-sebny,1903,607
1845,592,1335,0,1919,jackson-kelly-js32t-sbk,1919,743
1846,648,1271,8,1911,fender-american-professional-ii-stratocaster-rw-myst-sfg,1903,623
1847,592,1327,8,1911,hagstrom-super-viking-mfl,1903,735
1848,336,609,56,903,ibanez-pgmm21-paul-gilbert-mikro-mgn,847,273
1849,646,1271,8,1911,squier-classic-vibe-70s-tele-deluxe-owt,1903,625
1850,656,1263,8,1903,schecter-banshee-gt-fr-s-scb,1895,607
1851,314,639,0,959,peavey-raptor-plus-sss-black,959,325
1852,648,1271,0,1919,fender-player-telecaster-mn-tpl-10149927,1919,623
1853,616,1295,8,1911,hagstrom-alvar-sfr,1903,679
1854,304,647,8,957,gibson-les-paul-standard-60s-iced-tea,949,343
1855,656,1263,0,1911,ibanez-rg421msp-psp,1911,607
1856,632,1287,16,1903,epiphone-es-339-cherry-gibson-inspired,1887,655
1857,664,1255,16,1903,friedman-noho-trans-red,1887,591
1858,664,1255,0,1919,jackson-american-series-soloist-sl3-gloss-black,1919,591
1859,648,1271,8,1911,squier-contemporary-stratocaster-special-hh-gmtlmet,1903,623
1860,672,1247,0,1919,jackson-slat7p-ht-ms-sbb,1919,575
1861,656,1263,8,1911,charvel-pro-mod-dk-24-2pt-nat-mah,1903,607
1862,352,607,88,871,slick-sl-59-tvy,783,255
1863,656,1263,16,1903,ibanez-rg350dxz-wh,1887,607
1864,344,623,64,890,slick-sl-60-ba,826,279
1865,656,1255,8,1911,schecter-sun-valley-fr-s-gr,1903,599
1866,664,1271,48,1887,duesenberg-starplayer-tv-dtv-gt,1839,607
1867,600,1319,8,1911,d-angelico-deluxe-dc-le-sap,1903,719
1868,656,1263,0,1919,ibanez-s561-sfm,1919,607
1869,648,1263,16,1903,schecter-damien-platinum-6-fr,1887,615
1870,656,1255,8,1911,schecter-sls-elite-c-1-fr-black-fade-burst-lefthand,1903,599
1871,360,602,72,882,schecter-hellraiser-c-vi-bch,810,242
1872,0,623,8,959,heritage-custom-shop-core-collection-h-150-aged-tsb,951,623
1873,648,1263,8,1911,fender-jeff-beck-stratocaster-owh,1903,615
1874,664,1255,8,1911,schecter-sls-elite-c-1-fr-antique-fade-burst,1903,591
1875,648,1271,0,1919,charvel-pro-mod-san-dimas-style-1-hh-fr-m-qm,1919,623
1876,656,1255,0,1919,ibanez-az47p1qm-bib,1919,599
1877,648,1255,8,1903,schecter-silver-mountain-c-1-fr-s-bm,1895,607
1878,640,1279,0,1919,fender-american-performer-jazzmaster-rw-vwt,1919,639
1879,584,1327,8,1903,jackson-king-v-js32-mad,1895,743
1880,648,1271,8,1919,jackson-mj-series-dinky-dkr-snow-white,1911,623
1881,664,1247,8,1911,fender-vintera-60-s-mustang-3ts,1903,583
1882,117,362,0,479,danelectro-doubleneck-db-612-blk,479,245
1883,584,1335,0,1919,hagstrom-super-viking-wild-cherry-transparent-flame,1919,751
1884,624,1295,8,1911,gretsch-guitars-streamliner-g2215-p90-jr-jet,1903,671
1885,656,1263,16,1903,ibanez-ps60-bk-paul-stanley,1887,607
1886,648,1271,8,1911,evh-5150-dlx-aqua-burst,1903,623
1887,656,1263,16,1903,schecter-c-6-pro-aqb,1887,607
1888,632,1287,8,1911,gretsch-guitars-g2210-streamliner-jr-jet-gun-metal,1903,655
1889,664,1271,16,1903,duesenberg-senior-black,1887,607
1890,632,1287,24,1903,prs-se-mccarty-594-singelecut-standard-vintage-cherry,1879,655
1891,640,1271,8,1911,duesenberg-starplayer-deluxe-bk,1903,631
1892,584,1335,0,1919,jackson-pro-king-v-kvtmg-snow-white,1919,751
1893,320,639,0,951,harmony-standard-series-rebel-burgundy-10149882,951,319
1894,640,1279,0,1919,fender-american-ultra-jazzmaster-rw-ultrbst,1919,639
1895,592,1327,16,1903,d-angelico-deluxe-59-sh,1887,735
1896,619,1300,0,1919,ibanez-artist-ar520h-bk,1919,681
1897,656,1263,16,1903,schecter-reaper-6-custom-gw,1887,607
1898,632,1287,0,1919,gretsch-guitars-electromatic-g5222-double-ocean-turquoise,1919,655
1899,640,1287,0,1917,esp-e-ii-horizon-fr-rdb,1917,647
1900,616,1303,0,1919,yamaha-revstar-rse20swb-swift-blue-10146163,1919,687
1901,656,1263,0,1919,fender-eric-johnson-stratocaster-wbl,1919,607
1902,328,639,8,959,harmony-standard-series-jupiter-champagne,951,311
1903,664,1255,8,1903,ibanez-signature-jbbm30-bkl-jb-brubaker,1895,591
1904,648,1271,0,1919,fender-aerodyne-special-stratocaster-cab,1919,623
1905,648,1271,8,1911,schecter-aaron-marshall-am-6-tremolo-arctic-jade,1903,623
1906,640,1279,8,1911,fender-american-ultra-strat-hss-mn-arp,1903,639
1907,328,637,0,959,esp-ltd-mh-230qm-stbcsb,959,309
1908,648,1279,8,1911,squier-40th-anniversary-vintage-edition-telecaster-sdkr,1903,631
1909,320,639,0,958,gibson-les-paul-classic-heritage-cherry-sunburst-10113956,958,319
1910,592,1319,8,1903,gretsch-guitars-streamliner-g2420t-rb,1895,727
1911,312,650,8,951,esp-eclipse-custom-blue-liquid-metal,943,338
1912,664,1255,8,1911,ibanez-signature-atz100-andy-timmons-sbt,1903,591
1913,656,1263,8,1911,charvel-pro-mod-dk-24-ht-hh-sbk,1903,607
1914,640,1279,0,1919,fender-american-pro-ii-jazzmaster-mn-mbl,1919,639
1915,152,327,0,479,danelectro-59-m-modified,479,175
1916,656,1255,8,1903,jackson-js-series-dinky-arch-top-js22-mbl,1895,599
1917,640,1279,8,1911,fender-noventa-jazzmaster-mn-sfg-10149761,1903,639
1918,600,1319,8,1911,gretsch-guitars-electromatic-g5622-emtc-cb-dc-bristol-fog,1903,719
1919,600,1319,8,1903,gretsch-guitars-g6636t-players-edition-falcon-blk,1895,719
1920,640,1271,8,1911,fender-player-telecaster-mn-btb,1903,631
1921,648,1271,8,1911,fender-american-professional-ii-tele-dlx-rw-dk-nit-b-stock,1903,623
1922,656,1263,8,1911,jackson-x-series-slxdx-satin-white-swirl,1903,607
1923,288,679,8,951,guild-a-150-savoy-special-scw,943,391
1924,664,1255,0,1919,jackson-js32q-dka-tpb,1919,591
1925,600,1319,0,1911,squier-classic-vibe-starcaster-3ts,1911,719
1926,648,1271,16,1911,haar-traditional-s-sherwood-green,1895,623
1927,664,1255,8,1911,schecter-sls-elite-c-7-bfb,1903,591
1928,616,1295,0,1919,gretsch-guitars-electromatic-g5232t-double-jet-ft-fairlane-blue,1919,679
1929,664,1255,8,1911,schecter-hellraiser-hybrid-c-7-tbb,1903,591
1930,336,631,8,959,schecter-omen-8-wsn,951,295
1931,288,671,8,951,esp-ltd-arrow-401-blk-10129846,943,383
1932,328,639,8,951,suhr-modern-pro-hsh-mn-bb,943,311
1933,640,1279,0,1919,yamaha-pacifica-112v-ovs-10132194,1919,639
1934,656,1255,16,1895,gibson-custom-shop-63-sg-special-reissue-vos-10151741,1879,599
1935,672,1255,16,1903,ormsby-gti-s-hype-7-opeline-blue-b-stock,1887,583
1936,656,1263,0,1919,ibanez-gio-grg121sp-bmc,1919,607
1937,616,1303,8,1911,d-angelico-deluxe-mini-dc-sh,1903,687
1938,640,1287,16,1903,prs-s2-mccarty-594-singlecut-ev,1887,647
1939,312,647,8,951,jackson-rhoads-rrx24-gbk,943,335
1940,320,639,8,951,duesenberg-alliance-jeff-darosa,943,319
1941,584,1335,8,1911,hagstrom-tremar-viking-deluxe-wct,1903,751
1942,648,1271,24,1895,gibson-1957-les-paul-reissue-murphy-lab-10145839,1871,623
1943,352,612,56,903,ibanez-prestige-rgdr4327-ntf,847,260
1944,608,1311,8,1911,sterling-by-music-man-sub-stingray-sr30-guitar-daphne-blue,1903,703
1945,648,1255,8,1895,jackson-js-42-dinky-dkm-ht,1887,607
1946,656,1271,16,1903,duesenberg-senior-blonde,1887,615
1947,648,1271,8,1911,schecter-omen-elite-6-char,1903,623
1948,592,1327,8,1919,d-angelico-excel-dc-tour-collection-slate-blue,1911,735
1949,640,1279,8,1911,schecter-blackjack-solo-ii-gblk,1903,639
1950,320,639,0,959,yamaha-pacifica-212v-qm-tbl,959,319
1951,592,1319,0,1911,ibanez-artcore-af95-bs,1911,727
1952,648,1271,8,1911,squier-fsr-classic-vibe-70-s-strat-fsr-snb-limited,1903,623
1953,664,1247,24,1911,fender-player-offset-duo-sonic-hs-ssb,1887,583
1954,640,1279,8,1911,d-angelico-deluxe-atlantic-mwl,1903,639
1955,648,1263,16,1903,fender-custom-shop-1959-journeyman-relic-stratocaster-10131075,1887,615
1956,616,1303,8,1911,d-angelico-excel-dc-tour-collection-solid-wine-10152233,1903,687
1957,648,1271,8,1911,fender-vintera-50-s-strat-mod-2tsb-10150675,1903,623
1958,322,623,72,890,esp-usa-eclipse-fm-bh-cb-sd,818,301
1959,664,1255,16,1903,charvel-pro-mod-dk24-hh-2pt-cm-stnbgymst,1887,591
1960,664,1255,8,1911,gretsch-guitars-g5260-emtc-jet-bari-jde-gry,1903,591
1961,320,631,8,951,vintage-vs63vw,943,311
1962,328,631,0,959,stagg-silveray-custom-deluxe-fbk,959,303
1963,648,1271,0,1919,fender-gold-foil-telecaster-eb-cab,1919,623
1964,312,655,0,959,esp-eclipse-40th-anniversary-see-thru-black-sunburst,959,343
1965,280,671,8,959,schecter-ravendark-v-fr-gbsps,951,391
1966,312,647,8,951,esp-ltd-ec-1001-t-ctm,943,335
1967,304,655,8,951,eastman-t185mx-classic-thinline,943,351
1968,656,1263,0,1919,ibanez-iron-label-rgrtb621-bkf,1919,607
1969,376,583,176,783,epiphone-les-paul-classic-honey-burst,607,207
1970,624,1295,0,1919,gretsch-guitars-g6229t-sparkle-jet-champagne-sparkle,1919,671
1971,648,1271,8,1911,fender-70th-anniversary-esquire-sfg,1903,623
1972,312,631,0,959,gibson-60th-anniversary-1961-sg-les-paul-standard-reissue-10140939,959,319
1973,648,1279,8,1911,squier-classic-vibe-70s-tele-custom-3ts,1903,631
1974,656,1263,0,1919,charvel-pro-mod-san-dimas-2h-fr-sw,1919,607
1975,640,1263,8,1895,evh-striped-series-5150-r-b-w,1887,623
1976,320,631,0,959,gibson-les-paul-tribute-satin-tobacco-burst,959,311
1977,584,1327,16,1903,nik-huber-rietbergen-faded-sunburst,1887,743
1978,616,1303,0,1919,ibanez-artcore-am53-tf,1919,687
1979,648,1271,8,1911,fender-american-ultra-luxe-stratocaster-mn-prb,1903,623
1980,344,615,56,895,ibanez-prestige-rg5320-csw,839,271
1981,664,1255,8,1911,fender-player-offset-duo-sonic-dsd,1903,591
1982,648,1263,8,1911,schecter-c-6-plus-obb,1903,615
1983,320,638,0,959,g-l-fullerton-deluxe-legacy-bld,959,318
1984,624,1295,8,1911,gretsch-guitars-streamliner-g2215-p90-jr-jet-mnt,1903,671
1985,640,1271,0,1919,gretsch-guitars-guitars-g6129t-89-vintage-select-sparkle-jet-ssp,1919,631
1986,640,1279,5,1911,eastman-sb57-bk,1906,639
1987,320,639,0,959,g-l-tribute-asat-classic-eb,959,319
1988,304,655,0,959,esp-ltd-viper-1000-stpsb,959,351
1989,632,1279,0,1911,fender-player-jaguar-pf-capri-orange,1911,647
1990,608,1310,0,1919,duesenberg-starplayer-tv-nb,1919,702
1991,640,1279,16,1911,gibson-60th-anniversary-1961-sg-custom-reissue-10146891,1895,639
1992,328,634,8,951,ibanez-rg550-dy-genesis-collection,943,306
1993,616,1303,0,1919,jackson-x-series-rhoads-rrx24-winter-camo,1919,687
1994,664,1255,16,1903,ibanez-azs2209h-tfb-prestige,1887,591
1995,648,1271,16,1903,redwood-t-style-classic-mn-bsb-ash,1887,623
1996,640,1279,8,1911,sterling-by-music-man-john-petrucci-jp15-7-flame-maple-top-trans-black,1903,639
1997,608,1311,0,1919,ibanez-q52pb-abs,1919,703
1998,650,1278,0,1919,esp-e-ii-horizon-fr-ii-stbcsb,1919,628
1999,328,642,0,951,ibanez-gio-grx70qa-tbb,951,314
2000,616,1303,0,1919,yamaha-revstar-rsp20xrbc-rusty-brass-charcoal,1919,687
2001,648,1263,8,1911,fender-jimi-hendrix-stratocaster-mn-3ts,1903,615
2002,656,1255,1,1911,ibanez-axion-label-s671alb-bab,1910,599
2003,648,1271,0,1919,fender-american-performer-strat-mn-hss-ssfg,1919,623
2004,312,639,8,951,prs-se-santana-singlecut-trem-eg,943,327
2005,664,1255,8,1903,jackson-dinky-js12-mrd-10112464,1895,591
2006,632,1287,8,1911,sterling-by-music-man-cutlass-sss-tlb,1903,655
2007,320,639,0,959,yamaha-pacifica-212v-qm-cmb,959,319
2008,632,1287,8,1911,ibanez-artist-ar420-vls,1903,655
2009,384,575,176,783,epiphone-les-paul-prophecy-black-aged,607,191
2010,648,1271,8,1911,squier-classic-vibe-70s-stratocaster-hss-blk,1903,623
2011,344,615,80,879,slick-sl-57-ba,799,271
2012,592,1327,8,1911,squier-affinity-starcaster-mn-blk,1903,735
2013,648,1279,0,1911,fender-signature-tele-brent-mason-primer-grey,1911,631
2014,296,671,8,951,guild-starfire-iv-st-nt,943,375
2015,632,1287,0,1919,d-angelico-premier-brighton-ice-blue-metallic,1919,655
2016,648,1263,8,1903,prs-se-mark-holcomb-hbb-10151260,1895,615
2017,656,1263,8,1903,ibanez-gio-grg121dx-bkf,1895,607
2018,648,1271,8,1911,fender-chrissie-hynde-telecaster,1903,623
2019,576,1335,8,1911,hagstrom-fantomen-custom-blk,1903,759
2020,648,1271,0,1919,squier-40th-anniversary-vintage-edition-stratocaster-ssfg,1919,623
2021,288,639,8,951,schecter-e-1-fr-s,943,351
2022,592,1335,8,1903,nik-huber-rietbergen-translucent-green,1895,743
2023,640,1287,16,1903,prs-custom-24-mccarty-tobacco-sunburst,1887,647
2024,640,1279,0,1919,yamaha-pacifica-612-vii-fm-matte-silk-blue,1919,639
2025,664,1255,8,1911,ibanez-axion-label-rg60als-bam,1903,591
2026,664,1255,16,1903,schecter-hellraiser-hybrid-c-7-uvl,1887,591
2027,600,1319,8,1911,squier-contemporary-active-starcaster-flt-blk,1903,719
2028,640,1279,0,1911,gretsch-guitars-g6228t-jet-players-edition-dcm,1911,639
2029,762,1143,16,1903,duesenberg-alamo-multibender-lapsteel,1887,381
2030,632,1287,8,1911,gretsch-guitars-g2210-streamliner-jr-jet-vintage-white,1903,655
2031,656,1263,8,1911,schecter-hellraiser-hybrid-c-1-tbb,1903,607
2032,344,607,72,879,esp-usa-m-ii-fr-fm-e-stbc-emg,807,263
2033,317,641,0,959,esp-ltd-eclipse-87-nt-pw,959,324
2034,328,631,0,959,esp-ltd-m-7b-ht-black-metal-blks,959,303
2035,320,639,0,951,yamaha-pacifica-012-bl,951,319
2036,320,639,8,951,sandberg-california-st-ii-hca-3tsb-pff,943,319
2037,664,1255,8,1911,ibanez-prestige-rg5320c-pw,1903,591
2038,656,1255,24,1895,epiphone-prophecy-sg-black-aged,1871,599
2039,648,1271,16,1903,haar-traditional-s-aged-fiesta-red-kloppmann-hsh,1887,623
2040,656,1263,16,1903,haar-traditional-s-black,1887,607
2041,608,1311,8,1911,ibanez-artcore-as73g-bkf,1903,703
2042,648,1271,8,1911,squier-contemporary-stratocaster-special-ht-pwht,1903,623
2043,662,1255,0,1919,ibanez-rga742fm-tgf,1919,593
2044,592,1327,8,1909,d-angelico-excel-59-vnat,1901,735
2045,648,1263,8,1911,schecter-demon-6-absn-10117529,1903,615
2046,288,671,24,943,hagstrom-hl-550,919,383
2047,640,1279,16,1903,yamaha-pacifica-112v-yns,1887,639
2048,648,1271,8,1911,fender-american-professional-ii-telecaster-rw-owh,1903,623
2049,314,639,0,951,gretsch-guitars-g6129t-ft-players-edition-jet-bt-slv,951,325
2050,648,1271,0,1919,fender-jv-modified-50s-telecaster-white-blonde-mn,1919,623
2051,616,1295,48,1911,d-angelico-premier-ss-fr,1863,679
2052,616,1303,8,1911,d-angelico-deluxe-ss-stw,1903,687
2053,648,1271,0,1919,charvel-pro-mod-san-dimas-style-1-hss-platinum-pearl,1919,623
2054,656,1263,8,1911,jackson-js32q-dka-ht-trans-green-burst,1903,607
2055,320,631,0,951,esp-ltd-h3-1000fm-stpsb,951,311
2056,664,1255,0,1919,ibanez-azs2200-mgr,1919,591
2057,320,639,0,959,yamaha-pacifica-112j-bl,959,319
2058,656,1263,8,1911,ibanez-signature-jemjrl-wh-steve-vai-lefthand,1903,607
2059,600,1311,8,1903,jackson-king-v-js32t-fr,1895,711
2060,648,1271,8,1911,fender-noventa-strat-mn-dpb-10147643,1903,623
2061,648,1271,8,1911,charvel-pro-mod-san-dimas-style-1-hss-ht-e-sassafras,1903,623
2062,320,631,0,951,schecter-c-6-plus,951,311
2063,656,1255,8,1911,jackson-pro-dk-modern-ash-fr6-bk-wht,1903,599
2064,656,1263,8,1911,schecter-c-7-sls-evil-twin,1903,607
2065,624,1287,8,1903,gretsch-guitars-g6659tfm-player-s-edition-broadkaster-jr-cb-bbn,1895,663
2066,648,1271,0,1919,gretsch-guitars-g6134tfm-nh-nigel-hendroff-sign-penguin-dmf,1919,623
2067,312,647,5,951,ibanez-gax30-tcr,946,335
2068,656,1263,0,1919,jackson-x-series-soloist-slx-dx-red-crystal,1919,607
2069,672,1247,8,1911,ibanez-jbm27-jake-bowen,1903,575
2070,328,634,8,951,ibanez-prestige-rgr652ahbf-wk,943,306
2071,320,639,8,951,esp-ltd-ec-1000-et-qm-dbsb,943,319
2072,352,610,56,903,ibanez-prestige-rg2027xl-dtb,847,258
2073,632,1287,8,1911,gretsch-guitars-streamliner-g2217-jr-jet-club-bt-ibm,1903,655
2074,632,1279,0,1911,evh-wolfgang-special-gloss-black,1911,647
2075,648,1271,8,1911,evh-5150-standard-stealth-black,1903,623
2076,632,1279,0,1911,evh-wolfgang-standard-qm-northern-lights,1911,647
2077,656,1263,0,1919,charvel-pro-mod-san-dimas-sc1-satin-shell-pink,1919,607
2078,360,599,176,783,gibson-es-335-satin-vintage-burst-10151735,607,239
2079,320,631,8,959,esp-ltd-eclipse-87-blk,951,311
2080,640,1279,8,1911,sterling-by-music-man-cutlass-hss-vcr,1903,639
2081,664,1255,0,1919,ibanez-axion-label-rgd61ala-mtr,1919,591
2082,640,1279,8,1911,evh-5150-standard-ice-blue-metallic,1903,639
2083,656,1255,8,1903,schecter-silver-mountain-c-7-multiscale-toxic-venom,1895,599
2084,328,631,0,951,ibanez-prestige-az2204-icm,951,303
2085,664,1255,0,1919,squier-bullet-mustang-hh-sng,1919,591
2086,656,1263,0,1919,evh-striped-series-by,1919,607
2087,624,1295,8,1911,evh-wolfgang-standard-strryker-red,1903,671
2088,640,1287,8,1911,d-angelico-deluxe-atlantic-le-sap,1903,647
2089,269,695,0,959,danelectro-59m-spruce-f-hole-10084640,959,426
2090,640,1271,16,1903,epiphone-les-paul-studio-smokehouse-burst,1887,631
2091,608,1303,1,1911,jackson-warrior-js32t-nat,1910,695
2092,328,639,8,951,godin-stadium-ht-matte-black-mn,943,311
2093,328,631,0,951,jackson-pro-series-sl2-mick-thomson-blk,951,303
2094,664,1255,8,1917,schecter-sun-valley-fr-lambo-orange,1909,591
2095,640,1287,0,1919,esp-ltd-jm-ii-josh-middleton-signature,1919,647
2096,296,663,8,951,hagstrom-fantomen-wht,943,367
2097,648,1271,8,1911,fender-american-professional-ii-telecaster-mn-blk,1903,623
2098,648,1271,8,1911,squier-contemporary-stratocaster-special-ht-ssmet,1903,623
2099,320,607,24,935,epiphone-1961-les-paul-sg-standard,911,287
2100,640,1279,8,1911,gretsch-guitars-g5655t-cb-jr-dcm,1903,639
2101,736,1127,16,1911,duesenberg-fairytale-lapsteel-goldburst,1895,391
2102,644,1279,0,1915,esp-ltd-m-201-ht-black-satin,1915,635
2103,280,663,8,951,godin-5th-avenue-cw-kingpin-ii-p90-cb,943,383
2104,640,1279,16,1895,maybach-lester-wild-cherry-59-aged,1879,639
2105,368,591,176,783,epiphone-dot-es-335-frtb-inspired-by-gibson,607,223
2106,320,639,8,951,sandberg-california-st-ii-fiesta-red-hca,943,319
2107,320,639,0,951,danelectro-59-m-nos-modified-10082584,951,319
2108,648,1271,0,1919,evh-striped-series-frankie-r-w-b,1919,623
2109,640,1279,8,1911,fender-player-jazzmaster-pf-pwt,1903,639
2110,368,591,176,783,epiphone-flying-v-ebony,607,223
2111,608,1303,8,1911,jackson-rhoads-rr24x-woodland-camo,1903,695
2112,640,1279,8,1911,fender-roadworn-vintera-50s-tele-maple-sbl,1903,639
2113,648,1271,8,1911,fender-vintera-50-s-tele-mod-sfg,1903,623
2114,656,1263,8,1911,schecter-pt-special-candy-apple-red,1903,607
2115,640,1279,8,1911,gretsch-guitars-electromatic-g5655t-cb-center-block-jr-agrn,1903,639
2116,656,1271,16,1903,haar-traditional-s-lake-placid-blue-10147317,1887,615
2117,656,1263,8,1911,jackson-pro-soloist-sl2p-black-burst,1903,607
2118,648,1271,0,1919,squier-classic-vibe-60s-tele-thinline-sonic-blue-10151060,1919,623
2119,640,1279,8,1903,prs-se-custom-24-bgs,1895,639
2120,600,1311,8,1903,jackson-randy-rhoads-js32t-sw-bk,1895,711
2121,664,1247,0,1919,ibanez-mm7-tab-martin-miller-signature,1919,583
2122,640,1279,8,1911,sterling-by-music-man-john-petrucci-jp15-7-trans-black-satin,1903,639
2123,656,1263,8,1919,schecter-keith-merrow-km-7-mk-iii-artist-trans-black-burst,1911,607
2124,325,639,0,959,esp-ltd-mh-230qm-stbksb,959,314
2125,587,1327,24,1903,epiphone-casino-worn-10139313,1879,740
2126,640,1287,16,1903,esp-frx-liquid-metal-blue,1887,647
2127,328,647,0,954,ibanez-rg370ahmz-bmt,954,319
2128,280,679,8,951,esp-e-ii-arrow-nt-sw,943,399
2129,584,1335,8,1911,hagstrom-viking-transparent-cherry,1903,751
2130,632,1278,8,1911,schecter-synyster-gates-custom,1903,646
2131,296,663,16,943,hagstrom-tremar-viking-deluxe-blk,927,367
2132,648,1271,8,1911,fender-american-professional-ii-stratocaster-hss-mn-shp,1903,623
2133,648,1271,8,1911,fender-signature-robert-cray-standard,1903,623
2134,632,1287,8,1911,sterling-by-music-man-cutlass-ct30sss-fiesta-red,1903,655
2135,640,1279,0,1919,ibanez-yy20-ocs-yvette-young,1919,639
2136,648,1271,8,1911,fender-vintera-60-s-strat-mod-bgm,1903,623
2137,0,959,0,959,heritage-standard-h-150-dirty-lemon-burst,959,959
2138,656,1255,24,1895,ibanez-s521-mol,1871,599
2139,664,1263,24,1903,ormsby-gti-s-hype-6-opeline-blue-b-stock,1879,599
2140,313,647,0,959,esp-ltd-viper-201b-blk-black,959,334
2141,632,1287,16,1911,nik-huber-orca-59-tobacco-sunburst,1895,655
2142,584,1335,8,1911,hagstrom-fantomen-custom-white-gloss,1903,751
2143,640,1279,16,1911,duesenberg-starplayer-tv-bk-10149257,1895,639
2144,320,647,0,959,gretsch-guitars-g5425-jet-club-blk,959,327
2145,648,1271,8,1911,schecter-retro-c-1-e-a-cat-s-eye,1903,623
2146,656,1263,8,1919,ibanez-rg421ex-bkf,1911,607
2147,312,639,8,951,danelectro-64xt-vc,943,327
2148,640,1279,16,1911,gibson-60th-anniversary-1961-sg-custom-reissue,1895,639
2149,656,1263,8,1911,caparison-horus-m3-ef-ll,1903,607
2150,600,1319,16,1911,ibanez-signature-jsm20-bkl-john-scofield,1895,719
2151,616,1303,24,1895,prs-se-hollowbody-ii-tricolor-sunburst,1871,687
2152,648,1271,24,1895,gibson-1957-les-paul-reissue-murphy-lab-10145656,1871,623
2153,656,1255,8,1911,squier-fsr-classic-vibe-60-s-mustang-fsr-lpb,1903,599
2154,656,1271,32,1895,gibson-custom-shop-1959-les-paul-standard-ultraheavyaged-10152221,1863,615
2155,300,663,136,823,danelectro-59m-spruce-f-hole-10084642,687,363
2156,640,1279,8,1911,sterling-by-music-man-john-petrucci-jp60-stealth-black,1903,639
2157,648,1271,16,1911,esp-p-snapper-ctm-maple-drift-wood-burner-satin,1895,623
2158,352,599,103,855,vintage-v52bs,752,247
2159,640,1287,8,1906,jackson-x-series-mm-dominiontr-blu,1898,647
2160,640,1279,8,1911,sterling-by-music-man-cutlass-hss-dc,1903,639
2161,656,1263,8,1911,jackson-soloist-slx-m-snow-white,1903,607
2162,616,1303,24,1895,prs-se-hollowbody-ii-tricolor-sunburst-10148963,1871,687
2163,640,1290,2,1911,esp-ltd-eclipse-87-rbcrk-10134129,1909,650
2164,672,1255,8,1903,schecter-keith-merrow-km-7-mk-iii-standard-tbb,1895,583
2165,648,1279,16,1903,haar-traditional-t-deluxe-10134900,1887,631
2166,640,1279,16,1903,prs-s2-custom-24-msb,1887,639
2167,648,1271,8,1911,fender-noventa-strat-mn-sfg,1903,623
2168,328,631,0,959,ibanez-rg565-vk,959,303
2169,648,1263,8,1903,squier-bullet-fat-strat-rw-bsb-10104190,1895,615
2170,600,1316,0,1911,squier-classic-vibe-starcaster-nat,1911,716
2171,664,1255,16,1911,ibanez-azs2200-bk-prestige,1895,591
2172,298,661,0,959,ibanez-artcore-as53-tkf-10128988,959,363
2173,640,1279,8,1911,fender-parallel-universe-ii-tele-magico-sfg-transp,1903,639
2174,375,583,188,771,godin-session-ht-trans-cream-rn,583,208
2175,656,1263,16,1895,schecter-kenny-hickey-c-1-ex-s,1879,607
2176,648,1271,0,1911,fender-american-performer-tele-hum-rw-aub,1911,623
2177,632,1287,16,1903,nik-huber-orca-bernie-marsden-signature,1887,655
2178,600,1311,0,1911,gretsch-guitars-electromatic-g5622t-emtc-cb-dc-dcm,1911,711
2179,648,1271,0,1919,charvel-pro-mod-socal-style-1-fr-e-satin-primer-grey,1919,623
2180,640,1298,8,1903,prs-se-zach-myers-594-myers-blue,1895,658
2181,648,1263,8,1903,schecter-reaper-6-sib,1895,615
2182,328,639,0,951,slick-sl-54-m-bk,951,311
2183,640,1279,0,1919,yamaha-pacifica-112vm-ib,1919,639
2184,307,652,0,959,duesenberg-starplayer-tv-bks,959,345
2185,592,1327,0,1919,ibanez-af95-da,1919,735
2186,328,631,8,951,guild-s-100-polara,943,303
2187,605,1314,0,1919,danelectro-59x-dark-red,1919,709
2188,648,1263,16,1903,schecter-blackjack-c-1-gblk,1887,615
2189,640,1271,8,1903,schecter-apocalypse-pt-red-reign,1895,631
2190,600,1319,8,1911,gretsch-guitars-electromatic-g5622t-emtc-cb-dc-single-barrel-burst,1903,719
2191,648,1271,8,1911,fender-custom-shop-58-stratocaster-relic,1903,623
2192,640,1271,8,1911,fender-american-performer-jazzmaster-rw-3tsb,1903,631
2193,318,645,0,959,esp-ltd-bb-600-qm-stblksbs-b-stock,959,327
2194,616,1303,0,1919,yamaha-revstar-rsp02tswb-swift-blue,1919,687
2195,632,1279,8,1909,gretsch-guitars-g2655t-cb-jr-phntm,1901,647
2196,608,1311,8,1911,schecter-sls-elite-e-1-afb,1903,703
2197,307,650,1,959,esp-ltd-viper-400-pnkbfd,958,343
2198,640,1279,8,1911,squier-contemporary-telecaster-rh-gunmetal-metallic,1903,639
2199,656,1263,8,1903,ibanez-gio-gsa60-wnf,1895,607
2200,640,1279,16,1903,prs-custom-24-black-goldburst-10143905,1887,639
2201,648,1263,16,1903,epiphone-les-paul-muse-wanderlust-metallic-green,1887,615
2202,648,1269,0,1911,jackson-monarkh-sc-js22-snow-whiite,1911,621
2203,648,1284,0,1903,duesenberg-alliance-joe-walsh-bk,1903,636
2204,648,1271,8,1911,jackson-usa-signature-adrian-smith-san-dimas-dk-swht-eb,1903,623
2205,640,1303,0,1911,jackson-rr-minion-js1x-satin-black,1911,663
2206,344,615,88,871,suhr-modern-satin-hsh-rw-ns,783,271
2207,344,607,88,871,slick-sl-57-m-sg,783,263
2208,656,1263,8,1903,schecter-c-1-apocalypse-rr,1895,607
2209,648,1271,0,1919,fender-american-vintage-ii-1975-telecaster-deluxe-3-tone,1919,623
2210,320,642,8,951,guild-s-200-t-bird-atb-b-stock,943,322
2211,656,1263,0,1919,ibanez-rg565-for,1919,607
2212,656,1255,0,1919,ibanez-az2203n-atq,1919,599
2213,328,634,8,951,esp-e-ii-m-ii-nt-hs-dbtsb,943,306
2214,648,1271,0,1919,charvel-satchel-signature-pro-mod-dk-22-satin-white-bengal,1919,623
2215,320,631,0,959,esp-ltd-h-1001frqm-vshfd,959,311
2216,592,1327,0,1919,hagstrom-super-viking-black-gloss,1919,735
2217,640,1279,8,1911,evh-wolfgang-standard-qm-black-fade,1903,639
2218,648,1271,8,1911,fender-american-professional-ii-stratocaster-hss-rw-owt,1903,623
2219,656,1271,16,1911,haar-traditional-s-aged-fiesta-red-kloppmann-deml-hss,1895,615
2220,656,1263,8,1911,charvel-marco-sfogli-signature-pro-mod-so-cal-style-1-tpb,1903,607
2221,648,1271,8,1911,hagstrom-ultra-max-special-cold-steel-metallic,1903,623
2222,640,1279,8,1903,d-angelico-deluxe-brighton-le-rus,1895,639
2223,328,623,8,951,esp-ltd-deluxe-h-1007-stbk,943,295
2224,640,1279,16,1895,danelectro-59x12-vc,1879,639
2225,640,1279,0,1919,squier-contemporary-active-jazzmaster-spp,1919,639
2226,664,1263,16,1903,ormsby-gti-s-hype-6-black-b-stock,1887,599
2227,624,1298,0,1911,esp-ltd-phoenix-arctic-metal-sws,1911,674
2228,664,1247,24,1911,fender-player-offset-duo-sonic-sfmg,1887,583
2229,328,635,0,959,ibanez-premium-s1070pbz-clb,959,307
2230,608,1303,8,1911,jackson-rhoads-rr24x-black-camo-10144422,1903,695
2231,664,1255,0,1919,ibanez-tqms1-ctb-tom-quayle,1919,591
2232,648,1263,8,1911,fender-jeff-beck-stratocaster-sgr,1903,615
2233,632,1287,0,1919,fender-player-plus-meteora-hh-3-tone-sunburst,1919,655
2234,640,1279,0,1919,fender-american-vintage-ii-1966-jazzmaster-lpb,1919,639
2235,656,1263,8,1911,ibanez-ps10-bk-paul-stanley,1903,607
2236,592,1327,16,1903,d-angelico-excel-59-vio,1887,735
2237,656,1263,0,1919,ibanez-gio-grg220pa-rlb,1919,607
2238,640,1287,8,1903,prs-custom-24-black-goldburst-10141239,1895,647
2239,648,1271,0,1919,fender-american-vintage-ii-1972-telecaster-thinline-lpb,1919,623
2240,600,1319,0,1919,ibanez-artcore-express-as93fm-ays,1919,719
2241,664,1255,0,1919,ibanez-rgd7521pb-dsf,1919,591
2242,625,1303,0,1919,esp-ltd-aa-1-black-satin,1919,678
2243,632,1287,16,1903,danelectro-59xt-svr-blk,1887,655
2244,656,1263,8,1911,sterling-by-music-man-john-petrucci-majesty-ad,1903,607
2245,632,1287,8,1903,nik-huber-orca-bernie-marsden-signature-10149980,1895,655
2246,648,1271,8,1911,fender-american-performer-tele-rw-sbl,1903,623
2247,656,1263,8,1911,schecter-sun-valley-pt-fr-s-sfmg,1903,607
2248,678,1255,8,1911,blackstar-carry-on-travel-guitar-white,1903,577
2249,328,623,72,887,esp-usa-eclipse-qm-vn-duncan,815,295
2250,310,654,0,959,esp-ltd-viper-256-stbc,959,344
2251,648,1271,0,1919,fender-nile-rodgers-hitmaker-stratocaster-10149760,1919,623
2252,648,1271,8,1911,evh-5150-standard-neon-pink,1903,623
2253,656,1263,8,1911,schecter-reaper-7-elite-multiscale-deep-ocean-blue,1903,607
2254,696,1223,0,1919,duesenberg-pomona-multibender-lapsteel-10122903,1919,527
2255,656,1263,0,1919,ibanez-azes40-mgr,1919,607
2256,592,1319,0,1911,jackson-kelly-kex-gbk,1911,727
2257,640,1263,8,1911,friedman-vintage-t-gold-flake-light-aged,1903,623
2258,656,1263,0,1919,ibanez-azs2209b-bk,1919,607
2259,640,1279,8,1911,squier-bullet-tele-bsb,1903,639
2260,656,1263,16,1903,schecter-reaper-6-elite-deep-ocean-blue,1887,607
2261,288,655,8,943,danelectro-longhorn-guitar,935,367
2262,362,594,8,951,hoefner-shorty-blue,943,232
2263,648,1271,8,1911,jackson-soloist-sl1-dx-throwback-taxi-cab-yellow,1903,623
2264,648,1271,0,1919,fender-american-professional-ii-stratocaster-mn-ssb,1919,623
2265,648,1271,16,1903,sandberg-sandberg-electra-ii-dc-btb-mn,1887,623
2266,344,622,56,903,ibanez-sa360nqm-bmg,847,278
2267,664,1255,8,1911,jackson-pro-mdk6-evtn6-satin-graphit,1903,591
2268,640,1287,8,1903,heritage-standard-h-150-alb,1895,647
2269,312,647,0,959,esp-ltd-rm-600-reba-meyers-signature,959,335
2270,328,631,8,951,jackson-x-series-adrian-smith-sdxq-tgr,943,303
2271,648,1271,8,1911,fender-roadworn-vintera-50s-strat-mn-sbl-ltd-edition,1903,623
2272,312,647,8,951,guild-jetstar-st-sfg,943,335
2273,624,1295,8,1911,hagstrom-alvar-wild-cherry-transparent,1903,671
2274,616,1303,8,1911,schecter-e-1-apocalypse-red-reign,1903,687
2275,299,663,0,959,prs-se-hollowbody-standard-mtsb,959,364
2276,328,631,0,951,schecter-c-7-deluxe,951,303
2277,712,1207,224,1695,guild-surfliner-catalina-blue-b-stock,1471,495
2278,592,1327,8,1911,gretsch-guitars-g6120t-bssmk-59-smoke-brian-setzer-signature,1903,735
2279,648,1271,0,1919,squier-affinity-strat-fmt-hss-ssb,1919,623
2280,296,663,8,959,ibanez-artcore-as53-tf,951,367
2281,672,1247,8,1911,squier-paranormal-cyclone-tspg-pwt,1903,575
2282,648,1271,8,1903,squier-bullet-strat-bsb,1895,623
2283,312,647,16,951,prs-se-starla-stoptail-bl,935,335
2284,656,1271,0,1919,esp-e-ii-m-ii-7b-baritone-evertune-pw-10140788,1919,615
2285,608,1311,8,1903,gretsch-guitars-g6120t-sw-steve-wariner-signature-nashville,1895,703
2286,328,623,56,903,prs-s2-custom-24-08-frb,847,295
2287,656,1263,8,1911,caparison-dellinger-prominence-ef-tsbk,1903,607
2288,328,631,0,951,esp-e-ii-horizon-fr-7-qm-btb,951,303
2289,648,1263,8,1911,charvel-mj-guthrie-govan-hsh-3-tsb,1903,615
2290,592,1319,8,1911,gretsch-guitars-electromatic-g5622-emtc-cb-dc-black-gold,1903,727
2291,656,1255,1,1911,jackson-js-series-dinky-arch-top-js22-dka-sw,1910,599
2292,312,647,1,959,esp-ltd-te-200-maple-stbc,958,335
2293,624,1287,0,1919,gretsch-guitars-electromatic-g5230t-ft-alb,1919,663
2294,672,1247,8,1911,ibanez-rg5328-ldk,1903,575
2295,656,1263,8,1911,jackson-pro-soloist-sla-ht-unicorn-white,1903,607
2296,656,1263,0,1911,charvel-jake-e-lee-signature,1911,607
2297,328,644,0,951,ibanez-kiko10bp-tgb-kiko-loureiro,951,316
2298,648,1271,16,1903,maybach-teleman-t61-3tsb,1887,623
2299,632,1287,8,1911,fender-player-plus-meteora-hh-silverburst,1903,655
2300,600,1319,0,1919,ibanez-quest-ichi10-vwm,1919,719
2301,328,631,0,959,ibanez-signature-at100cl-sb-andy-timmons,959,303
2302,328,631,0,959,charvel-pro-mod-angel-vivaldi-sign-satin-black,959,303
2303,320,607,72,887,esp-usa-eclipse-sc-gh-sbm-emg,815,287
2304,600,1311,8,1903,gretsch-guitars-electromatic-g5422t-org-10145449,1895,711
2305,656,1261,0,1919,ibanez-prestige-rg5170b-bk,1919,605
2306,328,642,0,951,ibanez-rg421ahm-bmt,951,314
2307,587,1327,0,1911,gretsch-guitars-streamliner-g2622-sngbrl,1911,740
2308,640,1271,16,1903,duesenberg-julia-nb,1887,631
2309,584,1335,0,1919,gretsch-guitars-electromatic-g5422tg-dc-wlnt,1919,751
2310,656,1263,8,1911,ibanez-signature-jemjrsp-pk-steve-vai,1903,607
2311,584,1335,8,1911,hagstrom-super-viking-dandy-dandelion-flame-10131489,1903,751
2312,656,1263,16,1903,redwood-s-style-classic-rw-3ts,1887,607
2313,584,1327,0,1911,jackson-js-series-phil-demmel-demmelition-fury-sw-ht,1911,743
2314,656,1263,16,1903,schecter-reaper-6-sb,1887,607
2315,648,1271,0,1919,fender-american-professional-ii-stratocaster-rw-merc-10150393,1919,623
2316,648,1279,24,1903,prs-s2-custom-24-faded-grey-black-charcoalburst,1879,631
2317,648,1271,0,1919,fender-h-e-r-stratocaster-chrome-glow,1919,623
2318,640,1287,8,1903,heritage-standard-h-150-alb-10149386,1895,647
2319,640,1279,0,1919,fender-player-stratocaster-hss-pf-capri,1919,639
2320,648,1271,0,1919,fender-signature-joe-strummer-telecaster-10146754,1919,623
2321,656,1263,0,1919,squier-super-sonic-wppg-blsp,1919,607
2322,336,631,48,911,epiphone-les-paul-standard-50s-vintage-sunburst,863,295
2323,584,1335,8,1911,guild-starfire-i-jet-90-sbk,1903,751
2324,320,639,16,959,hagstrom-ultra-swede-cosmic-blackburst,943,319
2325,320,639,0,951,slick-sl-50-m-ba,951,319
2326,640,1271,8,1911,squier-classic-vibe-70s-tele-custom-blk,1903,631
2327,648,1271,8,1911,schecter-banshee-mach-6-eb,1903,623
2328,621,1303,0,1919,esp-ltd-deluxe-ec-1000t-ctm-evertune-blk,1919,682
2329,656,1263,0,1919,ibanez-pwm20-paul-waggoner,1919,607
2330,317,639,8,959,vintage-sg-vs6-cherry,951,322
2331,352,607,88,871,slick-sl-51-bwm,783,255
2332,664,1255,24,1911,fender-player-offset-duo-sonic-hs-crt,1887,591
2333,328,635,5,951,ibanez-ps60-ssl-paul-stanley,946,307
2334,605,1314,0,1919,danelectro-59-divine-dw,1919,709
2335,624,1303,8,1903,vox-sdc-1-mini-wh,1895,679
2336,656,1263,8,1911,fender-player-lead-iii-mtlc-prpl,1903,607
2337,584,1335,0,1919,gretsch-guitars-streamliner-g2622-cb-dc-mdsph,1919,751
2338,640,1279,0,1919,gretsch-guitars-g2655-cb-jr-frgmpl,1919,639
2339,600,1319,0,1919,ibanez-artstar-as113-bs,1919,719
2340,320,615,24,935,epiphone-slash-les-paul-standard-appetite-burst,911,295
2341,656,1255,8,1903,jackson-dinky-js12-swh,1895,599
2342,600,1335,8,1911,gretsch-guitars-g6120tg-ds-pro-player-s-edition-ruo,1903,735
2343,584,1327,24,1895,gamble-guitars-fly-10th-anniversary,1871,743
2344,656,1263,24,1895,haar-traditional-s-aged-vintage-white-10140995,1871,607
2345,632,1287,8,1911,gretsch-guitars-streamliner-g2655t-p90-midnight-saphire,1903,655
2346,624,1287,0,1911,evh-wolfgang-standard-exotic-ziricote,1911,663
2347,648,1271,0,1919,squier-affinity-strat-hh-bmm,1919,623
2348,368,599,144,815,danelectro-59m-spruce-f-hole,671,231
2349,664,1255,8,1903,schecter-sun-valley-fr-sfg,1895,591
2350,584,1335,8,1911,guild-starfire-i-jet-90-sbk-b-stock,1903,751
2351,656,1263,0,1919,ibanez-gio-grx120sp-mlm,1919,607
2352,632,1287,0,1919,gretsch-guitars-g6659t-ruo-bkstr-jr,1919,655
2353,592,1327,0,1919,ibanez-af75-trs,1919,735
2354,632,1279,8,1911,fender-vintera-60-s-jazzmaster-mod-3ts,1903,647
2355,632,1287,24,1903,music-man-valentine-sh-trm,1879,655
2356,656,1262,8,1911,ibanez-eh10-tgm,1903,606
2357,624,1303,8,1911,hagstrom-alvar-black,1903,679
2358,648,1263,8,1911,fender-vintera-70-s-tele-deluxe-3ts,1903,615
2359,656,1263,0,1919,ibanez-premium-rgt1221pb-dtf,1919,607
2360,632,1279,0,1919,d-angelico-premier-brighton-satin-sherwood-green,1919,647
2361,600,1311,16,1895,gibson-custom-shop-1961-es-335-vos-vintage-burst-10149290,1879,711
2362,320,645,8,951,guild-aristocrat-hh-trans-black-b-stock,943,325
2363,328,639,56,903,ibanez-artcore-ag85-bkf,847,311
2364,600,1311,0,1911,jackson-kelly-js32-frd-10148010,1911,711
2365,656,1263,6,1911,ibanez-rg421ex-tcm,1905,607
2366,328,631,0,959,vintage-stratocaster-v6mrbk,959,303
2367,664,1247,0,1911,fender-american-performer-mustang-rw-sbl,1911,583
2368,608,1303,0,1911,jackson-warrior-js32-white-black,1911,695
2369,664,1255,8,1911,schecter-keith-merrow-km-7-mk-iii-hybrid-fr-s-lambo-green,1903,591
2370,600,1314,8,1911,eastman-thinline-t486-rd,1903,714
2371,632,1279,24,1903,prs-se-245-singlecut-ca,1879,647
2372,624,1295,8,1903,danelectro-59x-blk,1895,671
2373,584,1335,16,1911,guild-starfire-i-dc-tr-emg,1895,751
2374,304,655,0,959,esp-e-ii-eclipse-bm-blue-natural-fade,959,351
2375,296,658,8,951,hagstrom-viking-deluxe-baritone-tobacco-sunburst,943,362
2376,312,641,0,959,esp-ltd-sn-1000ht-purpblast-purple-blast,959,329
2377,656,1263,8,1911,schecter-sls-elite-c-1-fr-black-fade-burst-10134558,1903,607
2378,320,639,0,959,esp-ltd-m-200fm-str-see-thru-red,959,319
2379,328,634,8,951,esp-e-ii-m-ii-nt-hs-blknf,943,306
2380,640,1279,16,1903,gibson-custom-shop-1957-les-paul-junior-vs-10149326,1887,639
2381,656,1263,8,1911,schecter-nick-johnston-traditional-af,1903,607
2382,640,1279,8,1911,fender-jim-atkins-ja-90-telecaster-thinline-wht,1903,639
2383,642,1271,8,1911,fender-vintera-50-s-strat-sfmg,1903,629
2384,656,1263,8,1911,ibanez-prestige-az2402-bkf,1903,607
2385,632,1287,8,1911,gretsch-guitars-g2210-streamliner-jr-jet-gold-dust,1903,655
2386,646,1271,8,1911,fender-american-performer-tele-hum-rw-ssfg,1903,625
2387,656,1263,0,1919,jackson-x-series-soloist-slx-dx-red-crystal-10152326,1919,607
2388,648,1263,8,1911,fender-player-stratocaster-mn-tpl,1903,615
2389,592,1319,8,1903,gretsch-guitars-streamliner-g2420t-gldst,1895,727
2390,592,1319,0,1911,gretsch-guitars-streamliner-g2622t-rvbl,1911,727
2391,648,1263,8,1911,fender-player-stratocaster-hss-mn-pwt,1903,615
2392,640,1287,8,1911,gretsch-guitars-electromatic-g5210t-p90-mako,1903,647
2393,648,1271,8,1911,fender-noventa-strat-mn-dpb,1903,623
2394,664,1255,8,1911,ibanez-azs2200f-stb-prestige,1903,591
2395,632,1282,8,1911,hagstrom-ultra-max-special-vinterny-metallic,1903,650
2396,570,1346,0,1911,esp-ltd-signature-kh-v-bsp,1911,776
2397,320,607,24,935,epiphone-les-paul-prophecy-red-tiger,911,287
2398,320,631,8,959,vintage-icon-v6mrtbg,951,311
2399,632,1287,8,1911,squier-contemporary-jaguar-hh-skyburst-metallic,1903,655
2400,293,671,8,951,guild-starfire-i-dc-blu,943,378
2401,320,631,8,953,slick-sl-55-vc,945,311
2402,328,623,8,951,gibson-1961-sg-standard-reissue-v-o-s-10151867,943,295
2403,328,638,0,959,esp-ltd-mh-400b-blks-black-satin,959,310
2404,320,639,0,959,jackson-monarkh-js22-rst,959,319
2405,595,1324,0,1919,duesenberg-starplayer-tv-chg,1919,729
2406,592,1327,0,1919,gretsch-guitars-electromatic-g5622t-emtc-cb-dc-asp-10150463,1919,735
2407,309,650,0,959,esp-ltd-viper-256-sw,959,341
2408,648,1271,8,1911,squier-bullet-strat-awt,1903,623
2409,608,1308,0,1919,duesenberg-starplayer-tv-phonic-pc-bk,1919,700
2410,664,1255,0,1919,ibanez-prestige-az24047-bk-10132235,1919,591
2411,592,1327,0,1919,gretsch-guitars-g6120t-hr-brian-setzer-hot-rod-cm,1919,735
2412,624,1295,8,1911,sterling-by-music-man-sub-axis-trans-gold,1903,671
2413,672,1247,8,1911,jackson-js22-7-dka-qm-trans-black-burst,1903,575
2414,656,1263,8,1911,schecter-nick-johnston-traditional-hss-ag,1903,607
2415,632,1287,8,1911,sterling-by-music-man-cutlass-short-scale-hs-shell-pink,1903,655
2416,648,1271,8,1911,jackson-dinky-dk3xr-cobalt-blue,1903,623
2417,344,613,80,878,slick-sl-57-m-sb,798,269
2418,312,647,0,959,esp-ltd-ec-bks-blks-black-metal,959,335
2419,648,1263,24,1895,gibson-1960-les-paul-junior-doublecut-eb,1871,615
2420,656,1271,24,1903,fender-custom-shop-limited-edition-1956-stratocaster-10144418,1879,615
2421,640,1279,0,1919,squier-40th-anniversary-vintage-edition-jazzmaster-ssfm,1919,639
2422,648,1263,8,1903,charvel-pro-mod-san-dimas-style-1-hh-fr-mbf,1895,615
2423,656,1263,8,1911,schecter-aaron-marshall-am-7-cobalt-slate,1903,607
2424,664,1255,8,1911,ibanez-rg420hpfm-alg,1903,591
2425,672,1239,0,1911,jackson-slat7-ms,1911,567
2426,328,639,0,959,schecter-omen-6-wsn,959,311
2427,616,1303,8,1911,d-angelico-premier-ss-ot,1903,687
2428,592,1319,8,1903,gretsch-guitars-streamliner-g2420-abb,1895,727
2429,648,1263,8,1903,haar-traditional-s-aged-blonde,1895,615
2430,664,1255,8,1911,schecter-sun-valley-fr-s-gw,1903,591
2431,320,631,5,951,slick-sl-55-sb,946,311
2432,592,1319,2,1919,eastman-thinline-t59-v-classic,1917,727
2433,648,1271,0,1911,fender-player-stratocaster-hss-floyd-mn-tpl,1911,623
2434,640,1284,16,1903,prs-john-mayer-silver-sky-roxy-pink,1887,644
2435,648,1271,0,1911,fender-player-stratocaster-pls-top-mn-acb,1911,623
2436,648,1271,8,1911,squier-mini-strat-shp,1903,623
2437,648,1263,8,1911,fender-signature-h-e-r-stratocaster,1903,615
2438,648,1271,8,1911,charvel-pro-mod-so-cal-3-hsh-fr-robins-egg-blue,1903,623
2439,656,1263,8,1911,jackson-mj-series-dinky-dkrp-trans-blue-burst,1903,607
2440,608,1303,8,1911,jackson-rhoads-js32-rr-natural-gold,1903,695
2441,624,1295,16,1903,nik-huber-piet-lake-placid-blue,1887,671
2442,320,634,8,951,slick-sl-51-bst,943,314
2443,648,1271,0,1919,squier-40th-anniversary-vintage-edition-telecaster-smoc,1919,623
2444,656,1271,16,1903,slick-sl-55-bk,1887,615
2445,600,1319,0,1919,ibanez-as73g-mpf,1919,719
2446,282,671,0,959,heritage-standard-h-150-vintage-original-sunburst,959,389
2447,648,1263,8,1903,jackson-dinky-js12-gbk-10126631,1895,615
2448,656,1263,8,1911,squier-super-sonic-wppg-ibm,1903,607
2449,624,1295,8,1903,nik-huber-piet-candy-tangerine,1895,671
2450,616,1303,0,1919,yamaha-revstar-rse20vw-vintage-white,1919,687
2451,320,638,0,959,esp-ltd-m-1-custom-87-car,959,318
2452,320,639,0,959,esp-ltd-m-1000-ms-fm-stblks,959,319
2453,648,1271,8,1911,fender-vintera-50-s-tele-2ts,1903,623
2454,672,1247,0,1919,ibanez-rg80f-ipt,1919,575
2455,656,1263,8,1911,schecter-reaper-6-fr-ccb,1903,607
2456,648,1271,16,1903,haar-traditional-s-aged-desert-sand,1887,623
2457,640,1279,8,1903,danelectro-59x12-bk,1895,639
2458,640,1271,0,1919,fender-american-ultra-stratocaster-mn-txt,1919,631
2459,640,1279,0,1919,fender-american-ultra-strat-hss-rw-cob,1919,639
2460,656,1271,32,1911,duesenberg-fullerton-tv-vintage-white,1879,615
2461,352,615,88,871,slick-sl-51-vc,783,263
2462,320,639,8,951,suhr-classic-s-hss-mn-vy,943,319
2463,616,1303,8,1911,d-angelico-deluxe-ss-le-sage,1903,687
2464,656,1255,8,1903,jackson-x-series-adrian-smith-sdx-lrl-sw-10149255,1895,599
2465,656,1279,0,1911,duesenberg-caribou-black,1911,623
2466,624,1303,24,1903,prs-se-hollowbody-standard-piezo-eib,1879,679
2467,328,631,80,875,eastman-thinline-t486-cla,795,303
2468,648,1271,0,1919,charvel-jake-e-lee-signature-pro-mod-so-cal-style-1-pwht,1919,623
2469,328,639,8,951,vintage-reissued-v65vbk,943,311
2470,648,1271,8,1911,fender-american-professional-ii-strat-hss-mn-rst-pine,1903,623
2471,304,655,24,935,epiphone-es-335-ch-inspired-by-gibson,911,351
2472,600,1319,8,1911,d-angelico-deluxe-dc-le-sage,1903,719
2473,376,583,176,783,gibson-60th-anniversary-60-les-paul-standard-reissue-v2-10141190,607,207
2474,320,639,0,959,schecter-hellraiser-c-1-fr-blk,959,319
2475,624,1287,0,1911,gretsch-guitars-g5230t-jet-ft-fbr,1911,663
2476,648,1271,8,1911,fender-american-professional-ii-stratocaster-rw-dk-nit,1903,623
2477,320,639,0,959,esp-ltd-mh-1000-evertune-stblk-see-thru-black,959,319
2478,664,1247,0,1911,jackson-pro-series-misha-mansoor-juggernaut-ht7-nor,1911,583
2479,368,591,176,783,epiphone-dot-es-335-ch,607,223
2480,672,1247,16,1903,duesenberg-starplayer-special-baritone-dsp-bk-d6,1887,575
2481,320,631,0,959,gibson-sg-standard-ebony-10113977,959,311
2482,656,1295,8,1911,epiphone-les-paul-standard-50s-metallic-gold-10149490,1903,639
2483,592,1314,8,1911,eastman-thinline-t59-v-amb,1903,722
2484,632,1287,8,1911,gretsch-guitars-electromatic-g5230t-ft-cgr,1903,655
2485,648,1271,8,1911,fender-player-stratocaster-hss-mn-blk,1903,623
2486,664,1255,16,1903,ormsby-gti-s-hype-6-azure-blue-b-stock,1887,591
2487,592,1327,0,1919,gretsch-guitars-g5420t-electromatic-classic-slvr,1919,735
2488,648,1271,0,1919,squier-affinity-tele-owh,1919,623
2489,624,1295,16,1903,danelectro-63-dano-bks,1887,671
2490,640,1279,8,1903,squier-classic-vibe-50s-stratocaster-frd,1895,639
2491,656,1263,8,1911,schecter-sun-valley-ss-exotic-ziricote,1903,607
2492,656,1255,0,1911,ibanez-rg421pb-chf,1911,599
2493,629,1293,1,1908,esp-ltd-ec-1000-fr-black-satin,1907,664
2494,648,1271,8,1903,haar-traditional-s-aged-black-10114208,1895,623
2495,352,615,80,871,slick-sl-51-m-db,791,263
2496,648,1271,8,1911,jackson-mj-misha-mansoor-signature-socal-dpb,1903,623
2497,728,1183,8,1903,gretsch-guitars-g5700-lap-steel-10014035,1895,455
2498,656,1263,0,1911,ibanez-rg421hpam-abl,1911,607
2499,328,639,0,951,schecter-c-6-deluxe-10080856,951,311
2500,600,1319,80,1903,d-angelico-premier-exl-1-sw,1823,719
2501,600,1319,0,1919,ibanez-prestige-artstar-as2000-bs-10144834,1919,719
2502,320,634,8,959,esp-ltd-mh-10-kit-blk,951,314
2503,656,1263,0,1919,ibanez-az42p1-bk,1919,607
2504,656,1255,0,1919,ibanez-az2407f-sde,1919,599
2505,320,639,1,959,esp-ltd-m-200fm-stbk-100011603,958,319
2506,344,615,56,903,ibanez-axion-label-s671alb-bcm,847,271
2507,648,1271,8,1911,schecter-damien-7-sbk,1903,623
2508,656,1255,24,1903,epiphone-slash-victoria-les-paul-standard-goldtop,1879,599
2509,640,1279,16,1903,prs-s2-custom-24-faded-grey-black-blue-burst-ltd-10151287,1887,639
2510,648,1271,16,1903,schecter-hellraiser-hybrid-pt-tbb,1887,623
2511,584,1335,8,1911,hagstrom-viking-tobacco-sunburst,1903,751
2512,640,1279,0,1919,squier-paranormal-cabronita-telecaster-thinline-lpb,1919,639
2513,656,1255,8,1903,jackson-js-series-dinky-arch-top-js22-dka,1895,599
2514,664,1255,0,1919,fender-vintera-60-s-mustang-sfmg,1919,591
2515,336,599,104,855,peavey-raptor-plus-sss-sunburst,751,263
2516,312,647,8,959,esp-e-ii-eclipse-db-vb,951,335
2517,656,1263,8,1911,jackson-js32q-dka-ht-trans-black-burst,1903,607
2518,328,631,0,951,jackson-usa-signature-misha-mansoor-juggernaut-ht6fm-sate,951,303
2519,648,1271,16,1919,prs-se-mark-holcomb,1903,623
2520,632,1287,0,1919,gretsch-guitars-streamliner-g2655t-cb-jr-strlgrn,1919,655
2521,640,1271,8,1911,squier-classic-vibe-50s-stratocaster-blk,1903,631
2522,624,1287,0,1919,gretsch-guitars-streamliner-g2215-p90-jr-jet-hv-oct,1919,663
2523,328,642,8,959,ibanez-s621qm-deb,951,314
2524,656,1263,8,1911,schecter-c-7-apocalypse-red-reign,1903,607
2525,272,687,0,951,danelectro-doubleneck-db-612-bbs,951,415
2526,320,647,8,951,paoletti-stratospheric-loft-hs-04-10-heavy-white,943,327
2527,600,1311,8,1903,gretsch-guitars-g6609-tg-broadcaster-pe-vw,1895,711
2528,616,1303,0,1919,yamaha-revstar-rss20vw-vintage-white,1919,687
2529,328,642,8,959,ibanez-signature-js2480-mcr-joe-satriani,951,314
2530,328,638,0,959,esp-ltd-mh-1007-evertune-blk-black,959,310
2531,648,1271,0,1919,squier-affinity-strat-hh-cfm,1919,623
2532,640,1279,16,1903,prs-s2-custom-24-wb,1887,639
2533,632,1279,8,1903,evh-wolfgang-special-ivory,1895,647
2534,344,618,56,895,ibanez-lhm1-luke-hoskin-tgg,839,274
2535,656,1263,8,1911,ibanez-mikro-grgm21m-blt,1903,607
2536,656,1263,0,1919,jackson-soloist-slx-dx-winter-camo,1919,607
2537,328,623,0,951,jackson-usa-signature-misha-mansoor-juggernaut-ht7fm-sate-10131774,951,295
2538,629,1293,5,1914,esp-ltd-ec-fr-black-metal-black-satin,1909,664
2539,664,1255,8,1911,ibanez-prestige-az2204-hrm,1903,591
2540,320,639,32,927,esp-ltd-ec1000-piezo-qm-stblk-see-thru-black-10093422,895,319
2541,616,1303,0,1919,ibanez-artstar-prestige-am2000h-bs,1919,687
2542,664,1255,24,1911,ibanez-rgrt421-wk,1887,591
2543,648,1263,8,1911,fender-american-performer-strat-mn-hss-blk,1903,615
2544,320,639,0,959,esp-ltd-sc20-3tb-stephen-carpenter,959,319
2545,704,1215,236,1687,guild-surfliner-hh-shoreline-mist,1451,511
2546,352,607,88,871,slick-sl-55-bst,783,255
2547,328,642,0,959,ibanez-rga42fm-def,959,314
2548,640,1279,8,1911,fender-player-plus-telecaster-mn-cmj,1903,639
2549,344,621,56,903,ibanez-rga42hp-sfm,847,277
2550,328,631,8,959,esp-ltd-m-1000-bp-prnb,951,303
2551,648,1263,16,1919,ibanez-sa360nqm-spb,1903,615
2552,312,631,8,951,yamaha-pacifica-112j-yns-3126050,943,319
2553,648,1271,8,1911,hagstrom-ultra-max-cosmic-black-burst-satin,1903,623
2554,632,1287,8,1911,evh-wolfgang-special-miami-blue,1903,655
2555,640,1271,16,1895,prs-se-standard-24-08-ts,1879,631
2556,320,639,0,959,esp-ltd-ec-1000-fm-asb-amber-sunburst,959,319
2557,648,1263,0,1911,fender-player-stratocaster-hss-pls-top-pf-tbs,1911,615
2558,600,1319,0,1919,squier-contemporary-active-starcaster-gmm,1919,719
2559,664,1255,0,1919,ibanez-prestige-az24047-bk,1919,591
2560,648,1271,8,1911,fender-player-stratocaster-pf-silver,1903,623
2561,328,639,8,959,esp-signature-kirk-hammett-kh-2-blk-neck-thru-body,951,311
2562,648,1271,16,1903,epiphone-les-paul-modern-figured-caribbean-blue-fade,1887,623
2563,632,1295,16,1903,danelectro-59xt-svr,1887,663
2564,312,647,4,959,esp-ltd-ec-401-ow,955,335
2565,656,1255,8,1903,schecter-silver-mountain-c-1-fr-s-tv,1895,599
2566,640,1271,8,1903,gretsch-guitars-g5655tg-center-block-jr-azm,1895,631
2567,648,1271,8,1911,charvel-pro-mod-angel-vivaldi-sign-satin-sage-green,1903,623
2568,624,1295,8,1911,evh-wolfgang-special-qm-charcoal-burst,1903,671
2569,600,1311,0,1911,jackson-kelly-js32-snow-white,1911,711
2570,656,1263,0,1919,ibanez-premium-s1070pbz-wfb,1919,607
2571,648,1271,8,1911,fender-lincoln-brewster-strat,1903,623
2572,656,1255,8,1911,schecter-sun-valley-fr-s-bl,1903,599
2573,648,1271,8,1911,fender-custom-shop-tomatillo-blackguard-tele-relic,1903,623
2574,656,1263,8,1911,jackson-pro-sl3q-blonde,1903,607
2575,640,1279,24,1911,epiphone-es-339-vintage-sunburst-gibson-inspired,1887,639
2576,650,1263,16,1903,yamaha-sg-1802-bl,1887,613
2577,664,1255,8,1911,gretsch-guitars-g5260t-emtc-jet-bari-bk,1903,591
2578,312,647,0,959,esp-ltd-te-200-sw-snow-white,959,335
2579,312,631,24,935,epiphone-es-339-natural,911,319
2580,624,1295,8,1903,d-angelico-deluxe-bedford-sh-dg,1895,671
2581,656,1271,24,1903,schecter-omen-extreme-6-bch,1879,615
2582,306,647,0,959,esp-ltd-ec-1000-evertune-bb-blks-black-satin,959,341
2583,672,1247,16,1903,fender-player-offset-mustang-90-bbm,1887,575
2584,648,1271,8,1911,fender-tash-sultana-stratocaster-tch,1903,623
2585,656,1263,0,1919,ibanez-sew761cw-ntf,1919,607
2586,656,1263,16,1903,jackson-dinky-js11-mrd-10117642,1887,607
2587,664,1255,0,1919,ibanez-azes40-prb,1919,591
2588,648,1271,0,1919,squier-affinity-tele-mn-3tsb,1919,623
2589,656,1263,8,1911,ibanez-rga42fm-tgf,1903,607
2590,348,612,92,871,slick-sl52-wh,779,264
2591,656,1263,8,1911,jackson-mj-series-dinky-dkr-ice-blue-metallic,1903,607
2592,656,1263,8,1911,schecter-omen-extreme-7-stbk,1903,607
2593,320,615,24,935,gibson-custom-shop-1957-les-paul-junior-tv-10149330,911,295
2594,328,639,8,951,suhr-modern-plus-hsh-trans-charcoal-burst,943,311
2595,376,583,176,783,epiphone-sg-standard-61-maestro-vibrola-cherry,607,207
2596,640,1271,8,1911,fender-player-stratocaster-pf-pwt,1903,631
2597,661,1263,8,1906,esp-ltd-m-7b-ht-baritone-arctic-metal-sws,1898,602
2598,609,1311,0,1914,esp-ltd-ps-1-vw-vintage-white,1914,702
2599,640,1279,0,1919,fender-american-ultra-strat-hss-rw-ultrbst,1919,639
2600,592,1327,8,1911,gretsch-guitars-g6120tg-pro-player-s-edition-nashville-orange-stain,1903,735
2601,640,1279,8,1911,gretsch-guitars-guitars-g6128t-89-vintage-select-duo-jet-blk,1903,639
2602,664,1255,8,1911,jackson-pro-dk2-slime-green,1903,591
2603,592,1327,0,1919,jackson-pro-kv7-cory-beaulieu-king-v-winterstorm,1919,735
2604,633,1287,0,1919,esp-ltd-ec-1000-baritone-charcoal-metallic-satin,1919,654
2605,312,647,8,951,gretsch-guitars-g6228fm-players-edition-jet-bt-bbs,943,335
2606,288,671,8,951,guild-starfire-i-sc-sfg,943,383
2607,296,663,3,959,guild-starfire-i-sc-vwn,956,367
2608,672,1247,8,1911,fender-player-offset-mustang-90-sfmg,1903,575
2609,344,615,80,879,slick-sl-51-m-bst,799,271
2610,320,639,8,951,sandberg-california-dc-ii-hcr-mf-mr,943,319
2611,648,1287,16,1903,gretsch-guitars-electromatic-g5232t-double-jet-ft-mns,1887,639
2612,296,655,6,956,guild-starfire-i-jet-90-sgld,950,359
2613,584,1327,8,1911,gretsch-guitars-streamliner-g2622-cb-dc-ocn-turq,1903,743
2614,632,1286,8,1911,sterling-by-music-man-john-petrucci-jp15-trans-black-satin,1903,654
2615,656,1263,0,1919,jackson-chris-broderick-pro-soloist-ht7-gblk,1919,607
2616,672,1247,0,1919,ibanez-axion-label-rgd71alpa-ckf,1919,575
2617,632,1287,0,1919,evh-wolfgang-standard-exotic-laurel-burl,1919,655
2618,640,1279,8,1911,fender-custom-shop-59telecaster-custom-relic,1903,639
2619,648,1271,8,1903,jackson-dinky-js11-sw,1895,623
2620,344,617,56,895,ibanez-prestige-rg5120m-fcn,839,273
2621,352,608,88,871,slick-sl-55-ba,783,256
2622,656,1255,8,1911,schecter-banshee-gt-fr-stp,1903,599
2623,648,1271,8,1911,fender-american-ultra-luxe-stratocaster-mn-2csb,1903,623
2624,656,1263,8,1911,jackson-dinky-dk3xr-black,1903,607
2625,600,1311,8,1911,eastman-thinline-t59-v-antique-red,1903,711
2626,616,1311,0,1917,esp-e-ii-eclipse-full-thickness-vhb,1917,695
2627,624,1282,16,1903,prs-se-245-singlecut-vs,1887,658
2628,344,607,72,887,ibanez-s520-wk,815,263
2629,392,567,200,759,ibanez-axion-label-rgd61alet-mgm,559,175
2630,592,1327,8,1911,jackson-kelly-kexm-neon-yellow,1903,735
2631,608,1279,16,1895,gibson-es-339-cherry,1879,671
2632,648,1263,0,1911,fender-player-stratocaster-hss-pf-3ts,1911,615
2633,664,1255,8,1911,schecter-john-browne-signature-tao-8-satin-trans-purple,1903,591
2634,320,639,8,951,suhr-modern-plus-hsh-tbds,943,319
2635,632,1279,8,1911,d-angelico-deluxe-brighton-le-sap,1903,647
2636,312,631,8,951,harmony-standard-series-rebel-champagne,943,319
2637,648,1271,0,1919,charvel-pro-modsan-dimas-style-1-hh-fr-lime-green-metallic,1919,623
2638,640,1279,16,1903,maybach-lester-midnight-sunset-60-aged,1887,639
2639,592,1319,8,1911,gretsch-guitars-streamliner-g2622t-p90-brownstone,1903,727
2640,656,1255,8,1911,jackson-soloist-sl3x-absynthe-frost,1903,599
2641,656,1263,8,1911,fender-player-lead-iii-ssb,1903,607
2642,624,1287,8,1911,evh-wolfgang-standard-exotic-bocote,1903,663
2643,328,631,8,951,g-l-fullerton-deluxe-asat-special-mn-ost,943,303
2644,648,1271,0,1919,jackson-x-series-dinky-dk3xr-hss-neon-pink,1919,623
2645,648,1271,8,1911,fender-noventa-tele-mn-vbl,1903,623
2646,328,631,0,951,jackson-dinky-js32-dka-m-snwh,951,303
2647,640,1279,8,1911,squier-mini-jazzmaster-dpb,1903,639
2648,656,1263,8,1911,fender-american-performer-strat-rw-awt,1903,607
2649,320,634,0,959,esp-ltd-m-1000-ht-bp-blkfd,959,314
2650,648,1271,0,1919,fender-american-vintage-ii-1975-telecaster-deluxe-blk,1919,623
2651,616,1303,8,1911,d-angelico-premier-ss-bf,1903,687
2652,656,1263,0,1919,ibanez-prestige-rg5121-bcf,1919,607
2653,616,1303,8,1911,ibanez-gb10em-jbb-george-benson,1903,687
2654,640,1279,16,1903,prs-se-silver-sky-ever-green,1887,639
2655,320,639,1,959,esp-horizon-i-andromeda-ii,958,319
2656,648,1271,0,1919,fender-american-professional-ii-stratocaster-mn-blk,1919,623
2657,648,1271,8,1911,sterling-by-music-man-john-petrucci-majesty-icr,1903,623
2658,288,671,8,951,esp-ltd-arrow-401-blk,943,383
2659,320,639,0,951,gretsch-guitars-original-g6128t-59-duo-jet-bk,951,319
2660,640,1279,16,1903,haar-traditional-t-vintage-white,1887,639
2661,664,1255,0,1919,gretsch-guitars-g5260-electromatic-jet-bari-brstl,1919,591
2662,648,1271,8,1903,fender-jason-isbell-custom-tele,1895,623
2663,648,1263,8,1911,jackson-marty-friedman-mf-1-purple-mirror,1903,615
2664,280,663,8,959,vintage-reissued-vsa500-mp-natural-maple,951,383
2665,640,1279,8,1903,maybach-lester-earl-grey-59-aged,1895,639
2666,616,1311,0,1919,esp-e-ii-eclipse-db-gs,1919,695
2667,592,1327,0,1919,gretsch-guitars-g5410t-emtc-hlw-ltd-tri-oct-wh,1919,735
2668,288,639,24,935,epiphone-casino-worn-blue-denim,911,351
2669,640,1271,24,1895,haar-traditional-t-aged-10083334,1871,631
2670,656,1247,8,1911,schecter-c-7-multiscale-sls-elite-gnat,1903,591
2671,632,1287,8,1911,fender-vintera-60-s-jaguar-mod-sbl,1903,655
2672,648,1271,16,1903,slick-sl-50-bk-10150346,1887,623
2673,320,637,0,959,esp-ltd-h-200fm-dbsb,959,317
2674,672,1247,40,1879,ibanez-signature-jem77p-bfp-steve-vai,1839,575
2675,720,1207,224,1695,guild-surfliner-sunset-orange-b-stock,1471,487
2676,624,1287,0,1919,squier-classic-vibe-60s-jaguar-olympic-white,1919,663
2677,656,1295,8,1911,epiphone-les-paul-standard-50s-metallic-gold,1903,639
2678,648,1271,0,1919,squier-affinity-strat-mn-owh,1919,623
2679,648,1271,16,1903,fender-custom-shop-60-telecaster-relic,1887,623
2680,576,1351,0,1914,esp-ltd-deluxe-arrow-1000-qm-cbs,1914,775
2681,640,1271,0,1919,fender-american-ultra-telecaster-rw-txt,1919,631
2682,320,647,8,959,harmony-standard-series-jupiter-pearl-white,951,327
2683,632,1287,16,1903,prs-custom-24-piezo-yellow-tiger,1887,655
2684,656,1263,0,1911,jackson-dinky-arch-top-js32-dka-sbk,1911,607
2685,656,1263,8,1911,jackson-soloist-slx-dx-multi-camo,1903,607
2686,584,1335,0,1919,gretsch-guitars-streamliner-g2622-cb-dc-frgmpl,1919,751
2687,656,1263,8,1911,fender-player-lead-iii-owt,1903,607
2688,305,650,0,959,esp-ltd-ec-256-stpsb,959,345
2689,648,1271,0,1919,fender-japan-hybrid-ii-stratocaster-blackout,1919,623
2690,624,1295,8,1911,squier-paranormal-offset-tele-tspg-olw,1903,671
